"","GCAM_region_ID","region","year","value_Total","value_F","value_M","sum_F_M","diff"
"1",1,"USA","1960",183061500,92335336,90726164,183061500,0
"2",1,"USA","1961",186125022,93977837,92147184,186125021,1
"3",1,"USA","1962",189023322,95551259,93472062,189023321,1
"4",1,"USA","1963",191786330,97053367,94732963,191786330,0
"5",1,"USA","1964",194483866,98522326,95961542,194483868,-2
"6",1,"USA","1965",196940500,99920040,97020460,196940500,0
"7",1,"USA","1966",199231195,101314527,97916670,199231197,-2
"8",1,"USA","1967",201406774,102673908,98732866,201406774,0
"9",1,"USA","1968",203423764,103884406,99539360,203423766,-2
"10",1,"USA","1969",205421450,104981775,100439676,205421451,-1
"11",1,"USA","1970",207833476,106201265,101632210,207833475,1
"12",1,"USA","1971",210494127,107512732,102981395,210494127,0
"13",1,"USA","1972",212789575,108662820,104126756,212789576,-1
"14",1,"USA","1973",214871907,109744262,105127647,214871909,-2
"15",1,"USA","1974",216883240,110814491,106068748,216883239,1
"16",1,"USA","1975",219061484,111978549,107082935,219061484,0
"17",1,"USA","1976",221175020,113112124,108062896,221175020,0
"18",1,"USA","1977",223420893,114317584,109103310,223420894,-1
"19",1,"USA","1978",225810350,115602450,110207898,225810348,2
"20",1,"USA","1979",228319271,116934223,111385046,228319269,2
"21",1,"USA","1980",230530636,118091979,112438657,230530636,0
"22",1,"USA","1981",232808405,119261161,113547245,232808406,-1
"23",1,"USA","1982",235041521,120388819,114652704,235041523,-2
"24",1,"USA","1983",237203486,121463955,115739531,237203486,0
"25",1,"USA","1984",239269790,122478201,116791588,239269789,1
"26",1,"USA","1985",241401760,123519960,117881801,241401761,-1
"27",1,"USA","1986",243643396,124612223,119031172,243643395,1
"28",1,"USA","1987",245831751,125682339,120149412,245831751,0
"29",1,"USA","1988",248073850,126778469,121295381,248073850,0
"30",1,"USA","1989",250425691,127916009,122509682,250425691,0
"31",1,"USA","1990",253263963,129295455,123968508,253263963,0
"32",1,"USA","1991",256647917,130946888,125701029,256647917,0
"33",1,"USA","1992",260204888,132681562,127523325,260204887,1
"34",1,"USA","1993",263641075,134368686,129272388,263641074,1
"35",1,"USA","1994",266882555,135964042,130918512,266882554,1
"36",1,"USA","1995",270068921,137526519,132542401,270068920,1
"37",1,"USA","1996",273226750,139073983,134152768,273226751,-1
"38",1,"USA","1997",276524787,140690589,135834199,276524788,-1
"39",1,"USA","1998",279743638,142251905,137491732,279743637,1
"40",1,"USA","1999",282948680,143783983,139164697,282948680,0
"41",1,"USA","2000",286081658,145284419,140797238,286081657,1
"42",1,"USA","2001",288896278,146663452,142232826,288896278,0
"43",1,"USA","2002",291557403,148013679,143543725,291557404,-1
"44",1,"USA","2003",294042533,149285085,144757450,294042535,-2
"45",1,"USA","2004",296740642,150638766,146101878,296740644,-2
"46",1,"USA","2005",299446414,151988351,147458064,299446415,-1
"47",1,"USA","2006",302293495,153418207,148875288,302293495,0
"48",1,"USA","2007",305122539,154853062,150269475,305122537,2
"49",1,"USA","2008",307963229,156303340,151659890,307963230,-1
"50",1,"USA","2009",310620343,157664158,152956186,310620344,-1
"51",1,"USA","2010",313157025,158963630,154193394,313157024,1
"52",1,"USA","2011",315370503,160018314,155352189,315370503,0
"53",1,"USA","2012",317620338,161017044,156603293,317620337,1
"54",1,"USA","2013",319761065,161966595,157794470,319761065,0
"55",1,"USA","2014",322029085,162988348,159040737,322029085,0
"56",1,"USA","2015",324319938,164031621,160288318,324319939,-1
"57",1,"USA","2016",326585943,165064523,161521419,326585942,1
"58",1,"USA","2017",328554695,165951971,162602724,328554695,0
"59",1,"USA","2018",330138554,166659845,163478709,330138554,0
"60",1,"USA","2019",331630316,167336231,164294083,331630314,2
"61",1,"USA","2020",334899359,168988423,165910939,334899362,-3
"62",1,"USA","2021",335400117,169327921,166072196,335400117,0
"63",1,"USA","2022",336614759,170024585,166590173,336614758,1
"64",10,"Central Asia","1960",34020089,17611001,16409087,34020088,1
"65",10,"Central Asia","1961",35186227,18196512,16989714,35186226,1
"66",10,"Central Asia","1962",36348196,18778308,17569891,36348199,-3
"67",10,"Central Asia","1963",37523013,19367470,18155541,37523011,2
"68",10,"Central Asia","1964",38718269,19968112,18750158,38718270,-1
"69",10,"Central Asia","1965",39900803,20561704,19339097,39900801,2
"70",10,"Central Asia","1966",41077139,21158111,19919030,41077141,-2
"71",10,"Central Asia","1967",42234238,21750813,20483425,42234238,0
"72",10,"Central Asia","1968",43380563,22337966,21042598,43380564,-1
"73",10,"Central Asia","1969",44500175,22911657,21588518,44500175,0
"74",10,"Central Asia","1970",45551224,23445379,22105844,45551223,1
"75",10,"Central Asia","1971",46551807,23950551,22601254,46551805,2
"76",10,"Central Asia","1972",47550907,24456368,23094540,47550908,-1
"77",10,"Central Asia","1973",48568084,24969332,23598751,48568083,1
"78",10,"Central Asia","1974",49612567,25495140,24117425,49612565,2
"79",10,"Central Asia","1975",50670313,26026621,24643696,50670317,-4
"80",10,"Central Asia","1976",51743951,26567472,25176479,51743951,0
"81",10,"Central Asia","1977",52847448,27125853,25721596,52847449,-1
"82",10,"Central Asia","1978",53964088,27690710,26273379,53964089,-1
"83",10,"Central Asia","1979",55051782,28236909,26814874,55051783,-1
"84",10,"Central Asia","1980",56107210,28763397,27343819,56107216,-6
"85",10,"Central Asia","1981",57181859,29300019,27881842,57181861,-2
"86",10,"Central Asia","1982",58298160,29856728,28441431,58298159,1
"87",10,"Central Asia","1983",59467591,30438927,29028663,59467590,1
"88",10,"Central Asia","1984",60683824,31046661,29637160,60683821,3
"89",10,"Central Asia","1985",61927991,31676674,30251315,61927989,2
"90",10,"Central Asia","1986",63254745,32365148,30889595,63254743,2
"91",10,"Central Asia","1987",64662758,33108131,31554626,64662757,1
"92",10,"Central Asia","1988",66080057,33858910,32221144,66080054,3
"93",10,"Central Asia","1989",66994398,34323063,32671333,66994396,2
"94",10,"Central Asia","1990",68082510,34850980,33231529,68082509,1
"95",10,"Central Asia","1991",69170307,35378056,33792253,69170309,-2
"96",10,"Central Asia","1992",70052671,35811232,34241436,70052668,3
"97",10,"Central Asia","1993",70722436,36151606,34570830,70722436,0
"98",10,"Central Asia","1994",71082745,36340472,34742273,71082745,0
"99",10,"Central Asia","1995",71300127,36456018,34844110,71300128,-1
"100",10,"Central Asia","1996",71678950,36657386,35021564,71678950,0
"101",10,"Central Asia","1997",72019898,36848420,35171480,72019900,-2
"102",10,"Central Asia","1998",72282267,37006691,35275579,72282270,-3
"103",10,"Central Asia","1999",72545528,37162253,35383274,72545527,1
"104",10,"Central Asia","2000",73019789,37410132,35609657,73019789,0
"105",10,"Central Asia","2001",73543096,37674130,35868965,73543095,1
"106",10,"Central Asia","2002",74112340,37959353,36152988,74112341,-1
"107",10,"Central Asia","2003",74737841,38271453,36466386,74737839,2
"108",10,"Central Asia","2004",75440564,38619100,36821461,75440561,3
"109",10,"Central Asia","2005",76192369,38988045,37204323,76192368,1
"110",10,"Central Asia","2006",76998806,39382100,37616708,76998808,-2
"111",10,"Central Asia","2007",77885371,39812284,38073086,77885370,1
"112",10,"Central Asia","2008",79052305,40382594,38669712,79052306,-1
"113",10,"Central Asia","2009",80285746,40985998,39299747,80285745,1
"114",10,"Central Asia","2010",81711761,41683399,40028362,81711761,0
"115",10,"Central Asia","2011",83159269,42391305,40767964,83159269,0
"116",10,"Central Asia","2012",84320282,42957187,41363095,84320282,0
"117",10,"Central Asia","2013",85576063,43571532,42004528,85576060,3
"118",10,"Central Asia","2014",86918231,44231546,42686684,86918230,1
"119",10,"Central Asia","2015",88307061,44916914,43390146,88307060,1
"120",10,"Central Asia","2016",89696041,45601997,44094047,89696044,-3
"121",10,"Central Asia","2017",91048474,46270673,44777798,91048471,3
"122",10,"Central Asia","2018",92415418,46948720,45466701,92415421,-3
"123",10,"Central Asia","2019",93843122,47658546,46184575,93843121,1
"124",10,"Central Asia","2020",95277041,48375436,46901607,95277043,-2
"125",10,"Central Asia","2021",96684923,49081249,47603673,96684922,1
"126",10,"Central Asia","2022",98523282,50005964,48517319,98523283,-1
"127",11,"China","1960",670361685,327529144,342832540,670361684,1
"128",11,"China","1961",663676772,324505645,339171127,663676772,0
"129",11,"China","1962",669261239,327440891,341820347,669261238,1
"130",11,"China","1963",685949518,335768846,350180671,685949517,1
"131",11,"China","1964",702060980,343801169,358259811,702060980,0
"132",11,"China","1965",718992178,352238255,366753923,718992178,0
"133",11,"China","1966",739247132,362293152,376953980,739247132,0
"134",11,"China","1967",758497951,371838087,386659865,758497952,-1
"135",11,"China","1968",778545629,381749341,396796288,778545629,0
"136",11,"China","1969",800129316,392388364,407740952,800129316,0
"137",11,"China","1970",822521284,403407829,419113454,822521283,1
"138",11,"China","1971",845400132,414644117,430756014,845400131,1
"139",11,"China","1972",866402269,424948169,441454101,866402270,-1
"140",11,"China","1973",886429438,434778466,451650972,886429438,0
"141",11,"China","1974",904975080,443900395,461074683,904975078,2
"142",11,"China","1975",921103519,451860101,469243417,921103518,1
"143",11,"China","1976",935449661,458952975,476496685,935449660,1
"144",11,"China","1977",948285105,465308537,482976567,948285104,1
"145",11,"China","1978",961078548,471649064,489429484,961078548,0
"146",11,"China","1979",974180305,478134045,496046261,974180306,-1
"147",11,"China","1980",986543432,484249137,502294296,986543433,-1
"148",11,"China","1981",999317095,490564960,508752134,999317094,1
"149",11,"China","1982",1014151192,497886010,516265180,1014151190,2
"150",11,"China","1983",1028921353,505174165,523747187,1028921352,1
"151",11,"China","1984",1042499491,511870703,530628787,1042499490,1
"152",11,"China","1985",1056783900,518885179,537898722,1056783901,-1
"153",11,"China","1986",1072614091,526623155,545990936,1072614091,0
"154",11,"China","1987",1089927308,535049971,554877335,1089927306,2
"155",11,"China","1988",1107582078,543616701,563965379,1107582080,-2
"156",11,"China","1989",1124673536,551869836,572803700,1124673536,0
"157",11,"China","1990",1141239727,559802777,581436950,1141239727,0
"158",11,"China","1991",1156894390,567247672,589646719,1156894391,-1
"159",11,"China","1992",1171142870,574008375,597134496,1171142871,-1
"160",11,"China","1993",1184721712,580463040,604258671,1184721711,1
"161",11,"China","1994",1198259179,586890129,611369051,1198259180,-1
"162",11,"China","1995",1211407741,593116254,618291487,1211407741,0
"163",11,"China","1996",1224389797,599266103,625123694,1224389797,0
"164",11,"China","1997",1236976000,605219912,631756089,1236976001,-1
"165",11,"China","1998",1248897476,610879846,638017629,1248897475,1
"166",11,"China","1999",1259767018,616015218,643751801,1259767019,-1
"167",11,"China","2000",1269741896,620686620,649055277,1269741897,-1
"168",11,"China","2001",1279003422,625084404,653919016,1279003420,2
"169",11,"China","2002",1287593765,629219469,658374296,1287593765,0
"170",11,"China","2003",1295593333,633070294,662523037,1295593331,2
"171",11,"China","2004",1303334029,636798042,666535987,1303334029,0
"172",11,"China","2005",1311021819,640501608,670520211,1311021819,0
"173",11,"China","2006",1318378963,644038682,674340281,1318378963,0
"174",11,"China","2007",1325316630,647373803,677942826,1325316629,1
"175",11,"China","2008",1332141838,650659190,681482650,1332141840,-2
"176",11,"China","2009",1338775821,653850095,684925727,1338775822,-1
"177",11,"China","2010",1345286497,657000361,688286135,1345286496,1
"178",11,"China","2011",1352677603,660604086,692073518,1352677604,-1
"179",11,"China","2012",1361922866,665126364,696796502,1361922866,0
"180",11,"China","2013",1371012274,669591439,701420834,1371012273,1
"181",11,"China","2014",1379693667,673888536,705805131,1379693667,0
"182",11,"China","2015",1387766539,677929478,709837062,1387766540,-1
"183",11,"China","2016",1395753288,681965380,713787908,1395753288,0
"184",11,"China","2017",1404246809,686320199,717926611,1404246810,-1
"185",11,"China","2018",1410863591,689822559,721041033,1410863592,-1
"186",11,"China","2019",1415916553,692571871,723344681,1415916552,1
"187",11,"China","2020",1419257283,694558501,724698782,1419257283,0
"188",11,"China","2021",1420459707,695578026,724881682,1420459708,-1
"189",11,"China","2022",1420216268,695858997,724357271,1420216268,0
"190",12,"EU-12","1960",88173858,45577729,42596127,88173856,2
"191",12,"EU-12","1961",88985467,45961836,43023630,88985466,1
"192",12,"EU-12","1962",89737781,46316995,43420789,89737784,-3
"193",12,"EU-12","1963",90543963,46702696,43841267,90543963,0
"194",12,"EU-12","1964",91396507,47114830,44281676,91396506,1
"195",12,"EU-12","1965",92096210,47449964,44646246,92096210,0
"196",12,"EU-12","1966",92773401,47778309,44995093,92773402,-1
"197",12,"EU-12","1967",93643832,48212363,45431470,93643833,-1
"198",12,"EU-12","1968",94458746,48621051,45837691,94458742,4
"199",12,"EU-12","1969",95156261,48972274,46183987,95156261,0
"200",12,"EU-12","1970",95665750,49231882,46433868,95665750,0
"201",12,"EU-12","1971",96151096,49480632,46670464,96151096,0
"202",12,"EU-12","1972",96856667,49839291,47017377,96856668,-1
"203",12,"EU-12","1973",97595424,50213886,47381537,97595423,1
"204",12,"EU-12","1974",98399837,50621553,47778282,98399835,2
"205",12,"EU-12","1975",99297693,51076578,48221118,99297696,-3
"206",12,"EU-12","1976",100194776,51533918,48660859,100194777,-1
"207",12,"EU-12","1977",101020697,51952397,49068301,101020698,-1
"208",12,"EU-12","1978",101722469,52305141,49417327,101722468,1
"209",12,"EU-12","1979",102338791,52615885,49722905,102338790,1
"210",12,"EU-12","1980",102937506,52918747,50018760,102937507,-1
"211",12,"EU-12","1981",103524035,53219018,50305017,103524035,0
"212",12,"EU-12","1982",104118271,53524294,50593978,104118272,-1
"213",12,"EU-12","1983",104677584,53811885,50865699,104677584,0
"214",12,"EU-12","1984",105208059,54087459,51120598,105208057,2
"215",12,"EU-12","1985",105704984,54347444,51357539,105704983,1
"216",12,"EU-12","1986",106188287,54601755,51586531,106188286,1
"217",12,"EU-12","1987",106656186,54849483,51806705,106656188,-2
"218",12,"EU-12","1988",107045270,55063262,51982010,107045272,-2
"219",12,"EU-12","1989",107162694,55142087,52020608,107162695,-1
"220",12,"EU-12","1990",107108430,55133507,51974919,107108426,4
"221",12,"EU-12","1991",106943351,55071279,51872072,106943351,0
"222",12,"EU-12","1992",106713685,54979427,51734259,106713686,-1
"223",12,"EU-12","1993",106638755,54968672,51670084,106638756,-1
"224",12,"EU-12","1994",106588811,54971606,51617208,106588814,-3
"225",12,"EU-12","1995",106484053,54948909,51535142,106484051,2
"226",12,"EU-12","1996",106329060,54898727,51430332,106329059,1
"227",12,"EU-12","1997",106167355,54842750,51324605,106167355,0
"228",12,"EU-12","1998",106006152,54788274,51217876,106006150,2
"229",12,"EU-12","1999",105867532,54746661,51120873,105867534,-2
"230",12,"EU-12","2000",105317846,54467143,50850701,105317844,2
"231",12,"EU-12","2001",104718257,54154910,50563348,104718258,-1
"232",12,"EU-12","2002",104035740,53813983,50221758,104035741,-1
"233",12,"EU-12","2003",103719700,53653899,50065800,103719699,1
"234",12,"EU-12","2004",103447068,53512448,49934618,103447066,2
"235",12,"EU-12","2005",103172662,53367596,49805064,103172660,2
"236",12,"EU-12","2006",102922068,53236252,49685816,102922068,0
"237",12,"EU-12","2007",102549128,53044436,49504691,102549127,1
"238",12,"EU-12","2008",102193947,52858580,49335369,102193949,-2
"239",12,"EU-12","2009",102018745,52759377,49259371,102018748,-3
"240",12,"EU-12","2010",101670214,52567504,49102710,101670214,0
"241",12,"EU-12","2011",101454770,52443167,49011601,101454768,2
"242",12,"EU-12","2012",101244344,52322599,48921742,101244341,3
"243",12,"EU-12","2013",101050972,52213810,48837165,101050975,-3
"244",12,"EU-12","2014",100869343,52109157,48760187,100869344,-1
"245",12,"EU-12","2015",100686615,51997972,48688640,100686612,3
"246",12,"EU-12","2016",100473166,51869070,48604097,100473167,-1
"247",12,"EU-12","2017",100292069,51757199,48534864,100292063,6
"248",12,"EU-12","2018",100154069,51665200,48488870,100154070,-1
"249",12,"EU-12","2019",100066182,51599812,48466369,100066181,1
"250",12,"EU-12","2020",99885313,51499693,48385620,99885313,0
"251",12,"EU-12","2021",99294721,51203096,48091620,99294716,5
"252",12,"EU-12","2022",98569476,50789565,47779907,98569472,4
"253",13,"EU-15","1960",317339795,164576923,152762876,317339799,-4
"254",13,"EU-15","1961",319895487,165813367,154082120,319895487,0
"255",13,"EU-15","1962",322629358,167137198,155492162,322629360,-2
"256",13,"EU-15","1963",325353879,168452591,156901285,325353876,3
"257",13,"EU-15","1964",328063930,169760790,158303140,328063930,0
"258",13,"EU-15","1965",330836627,171103534,159733093,330836627,0
"259",13,"EU-15","1966",333465312,172376698,161088622,333465320,-8
"260",13,"EU-15","1967",335817941,173510854,162307089,335817943,-2
"261",13,"EU-15","1968",338019663,174575285,163444381,338019666,-3
"262",13,"EU-15","1969",340211089,175649857,164561230,340211087,2
"263",13,"EU-15","1970",342067067,176550558,165516511,342067069,-2
"264",13,"EU-15","1971",343914677,177435212,166479465,343914677,0
"265",13,"EU-15","1972",346015982,178457264,167558715,346015979,3
"266",13,"EU-15","1973",347898888,179378610,168520275,347898885,3
"267",13,"EU-15","1974",349507368,180157213,169350148,349507361,7
"268",13,"EU-15","1975",350906417,180837545,170068874,350906419,-2
"269",13,"EU-15","1976",352091741,181423220,170668523,352091743,-2
"270",13,"EU-15","1977",353187174,181965984,171221189,353187173,1
"271",13,"EU-15","1978",354357199,182553912,171803288,354357200,-1
"272",13,"EU-15","1979",355605347,183187905,172417440,355605345,2
"273",13,"EU-15","1980",356954491,183836511,173117984,356954495,-4
"274",13,"EU-15","1981",358110758,184380711,173730049,358110760,-2
"275",13,"EU-15","1982",358863435,184750423,174113011,358863434,1
"276",13,"EU-15","1983",359386282,184999373,174386911,359386284,-2
"277",13,"EU-15","1984",359862918,185223384,174639533,359862917,1
"278",13,"EU-15","1985",360453739,185502557,174951185,360453742,-3
"279",13,"EU-15","1986",361216504,185859234,175357268,361216502,2
"280",13,"EU-15","1987",362060122,186249557,175810567,362060124,-2
"281",13,"EU-15","1988",363117944,186745972,176371976,363117948,-4
"282",13,"EU-15","1989",364540812,187422033,177118778,364540811,1
"283",13,"EU-15","1990",366144874,188182603,177962270,366144873,1
"284",13,"EU-15","1991",368015753,189073435,178942316,368015751,2
"285",13,"EU-15","1992",369745280,189890512,179854771,369745283,-3
"286",13,"EU-15","1993",371312499,190626654,180685846,371312500,-1
"287",13,"EU-15","1994",372520716,191186332,181334390,372520722,-6
"288",13,"EU-15","1995",373620186,191702792,181917390,373620182,4
"289",13,"EU-15","1996",374685159,192209976,182475190,374685166,-7
"290",13,"EU-15","1997",375665864,192678727,182987140,375665867,-3
"291",13,"EU-15","1998",376577426,193117417,183460011,376577428,-2
"292",13,"EU-15","1999",377641586,193637068,184004518,377641586,0
"293",13,"EU-15","2000",378963523,194287638,184675884,378963522,1
"294",13,"EU-15","2001",380532506,195065207,185467301,380532508,-2
"295",13,"EU-15","2002",382459460,196003938,186455527,382459465,-5
"296",13,"EU-15","2003",384596571,197024803,187571772,384596575,-4
"297",13,"EU-15","2004",386841837,198089254,188752579,386841833,4
"298",13,"EU-15","2005",389072318,199139930,189932392,389072322,-4
"299",13,"EU-15","2006",391186982,200141755,191045226,391186981,1
"300",13,"EU-15","2007",393508249,201250865,192257388,393508253,-4
"301",13,"EU-15","2008",395759319,202325348,193433973,395759321,-2
"302",13,"EU-15","2009",397454018,203138987,194315031,397454018,0
"303",13,"EU-15","2010",398924203,203853506,195070693,398924199,4
"304",13,"EU-15","2011",398868031,203785569,195082461,398868030,1
"305",13,"EU-15","2012",400187854,204407235,195780614,400187849,5
"306",13,"EU-15","2013",401901365,205226673,196674688,401901361,4
"307",13,"EU-15","2014",403683035,206081457,197601577,403683034,1
"308",13,"EU-15","2015",405387267,206871151,198516112,405387263,4
"309",13,"EU-15","2016",407076352,207644669,199431682,407076351,1
"310",13,"EU-15","2017",408460081,208275731,200184350,408460081,0
"311",13,"EU-15","2018",409828212,208907918,200920296,409828214,-2
"312",13,"EU-15","2019",410687262,209298258,201389006,410687264,-2
"313",13,"EU-15","2020",411461021,209662668,201798351,411461019,2
"314",13,"EU-15","2021",411657237,209741486,201915753,411657239,-2
"315",13,"EU-15","2022",413131944,210466586,202665359,413131945,-1
"316",14,"Europe_Eastern","1960",53039266,29381973,23657294,53039267,-1
"317",14,"Europe_Eastern","1961",53764289,29726592,24037696,53764288,1
"318",14,"Europe_Eastern","1962",54454359,30052828,24401533,54454361,-2
"319",14,"Europe_Eastern","1963",55105810,30357480,24748329,55105809,1
"320",14,"Europe_Eastern","1964",55730091,30650497,25079595,55730092,-1
"321",14,"Europe_Eastern","1965",56298516,30917885,25380630,56298515,1
"322",14,"Europe_Eastern","1966",56842398,31173931,25668467,56842398,0
"323",14,"Europe_Eastern","1967",57390747,31434979,25955767,57390746,1
"324",14,"Europe_Eastern","1968",57910012,31680781,26229232,57910013,-1
"325",14,"Europe_Eastern","1969",58380386,31905019,26475367,58380386,0
"326",14,"Europe_Eastern","1970",58775600,32118611,26656988,58775599,1
"327",14,"Europe_Eastern","1971",59196364,32337659,26858705,59196364,0
"328",14,"Europe_Eastern","1972",59672705,32554048,27118657,59672705,0
"329",14,"Europe_Eastern","1973",60094888,32743623,27351265,60094888,0
"330",14,"Europe_Eastern","1974",60483667,32920362,27563305,60483667,0
"331",14,"Europe_Eastern","1975",60849898,33090093,27759804,60849897,1
"332",14,"Europe_Eastern","1976",61173567,33238181,27935386,61173567,0
"333",14,"Europe_Eastern","1977",61464176,33369814,28094362,61464176,0
"334",14,"Europe_Eastern","1978",61730272,33492505,28237768,61730273,-1
"335",14,"Europe_Eastern","1979",62016498,33619008,28397490,62016498,0
"336",14,"Europe_Eastern","1980",62332988,33755485,28577503,62332988,0
"337",14,"Europe_Eastern","1981",62671175,33905876,28765299,62671175,0
"338",14,"Europe_Eastern","1982",62925889,34011553,28914336,62925889,0
"339",14,"Europe_Eastern","1983",63199407,34127634,29071772,63199406,1
"340",14,"Europe_Eastern","1984",63483728,34252105,29231621,63483726,2
"341",14,"Europe_Eastern","1985",63739050,34362705,29376346,63739051,-1
"342",14,"Europe_Eastern","1986",64015175,34480390,29534784,64015174,1
"343",14,"Europe_Eastern","1987",64308907,34605305,29703601,64308906,1
"344",14,"Europe_Eastern","1988",64592424,34722782,29869641,64592423,1
"345",14,"Europe_Eastern","1989",64895317,34848112,30047206,64895318,-1
"346",14,"Europe_Eastern","1990",65046726,34898947,30147777,65046724,2
"347",14,"Europe_Eastern","1991",65167760,34938703,30229055,65167758,2
"348",14,"Europe_Eastern","1992",65342491,35003807,30338683,65342490,1
"349",14,"Europe_Eastern","1993",65393067,35011841,30381224,65393065,2
"350",14,"Europe_Eastern","1994",65115940,34856256,30259684,65115940,0
"351",14,"Europe_Eastern","1995",64659831,34612226,30047605,64659831,0
"352",14,"Europe_Eastern","1996",64164662,34354770,29809892,64164662,0
"353",14,"Europe_Eastern","1997",63648446,34086045,29562402,63648447,-1
"354",14,"Europe_Eastern","1998",63151690,33825850,29325840,63151690,0
"355",14,"Europe_Eastern","1999",62631360,33554852,29076510,62631362,-2
"356",14,"Europe_Eastern","2000",62080778,33273452,28807327,62080779,-1
"357",14,"Europe_Eastern","2001",61509084,32985336,28523749,61509085,-1
"358",14,"Europe_Eastern","2002",60979403,32719055,28260348,60979403,0
"359",14,"Europe_Eastern","2003",60512896,32481886,28031011,60512897,-1
"360",14,"Europe_Eastern","2004",60077795,32263069,27814726,60077795,0
"361",14,"Europe_Eastern","2005",59658071,32056920,27601152,59658072,-1
"362",14,"Europe_Eastern","2006",59273677,31866300,27407376,59273676,1
"363",14,"Europe_Eastern","2007",58944607,31700991,27243617,58944608,-1
"364",14,"Europe_Eastern","2008",58655007,31554392,27100614,58655006,1
"365",14,"Europe_Eastern","2009",58423127,31430701,26992425,58423126,1
"366",14,"Europe_Eastern","2010",58216931,31312988,26903943,58216931,0
"367",14,"Europe_Eastern","2011",58028428,31203209,26825220,58028429,-1
"368",14,"Europe_Eastern","2012",57900502,31119114,26781389,57900503,-1
"369",14,"Europe_Eastern","2013",57792417,31042650,26749767,57792417,0
"370",14,"Europe_Eastern","2014",57578485,30910299,26668187,57578486,-1
"371",14,"Europe_Eastern","2015",57451090,30827227,26623863,57451090,0
"372",14,"Europe_Eastern","2016",57277238,30725476,26551761,57277237,1
"373",14,"Europe_Eastern","2017",57045313,30594948,26450367,57045315,-2
"374",14,"Europe_Eastern","2018",56768506,30442848,26325657,56768505,1
"375",14,"Europe_Eastern","2019",56470185,30291704,26178481,56470185,0
"376",14,"Europe_Eastern","2020",56147131,30132286,26014846,56147132,-1
"377",14,"Europe_Eastern","2021",55710639,29912951,25797690,55710641,-2
"378",14,"Europe_Eastern","2022",49801178,26877590,22923589,49801179,-1
"379",15,"Europe_Non_EU","1960",45073447,22571537,22501908,45073445,2
"380",15,"Europe_Non_EU","1961",46034679,23042629,22992048,46034677,2
"381",15,"Europe_Non_EU","1962",47025086,23528668,23496419,47025087,-1
"382",15,"Europe_Non_EU","1963",48021968,24018307,24003663,48021970,-2
"383",15,"Europe_Non_EU","1964",49004051,24500377,24503673,49004050,1
"384",15,"Europe_Non_EU","1965",49954076,24967257,24986819,49954076,0
"385",15,"Europe_Non_EU","1966",50954034,25465866,25488164,50954030,4
"386",15,"Europe_Non_EU","1967",51995583,25987741,26007843,51995584,-1
"387",15,"Europe_Non_EU","1968",53038060,26520198,26517866,53038064,-4
"388",15,"Europe_Non_EU","1969",54057393,27039229,27018166,54057395,-2
"389",15,"Europe_Non_EU","1970",55045472,27522979,27522492,55045471,1
"390",15,"Europe_Non_EU","1971",56045788,27977867,28067921,56045788,0
"391",15,"Europe_Non_EU","1972",57059903,28412805,28647101,57059906,-3
"392",15,"Europe_Non_EU","1973",58084749,28857748,29227003,58084751,-2
"393",15,"Europe_Non_EU","1974",59103498,29298822,29804675,59103497,1
"394",15,"Europe_Non_EU","1975",60096093,29734448,30361644,60096092,1
"395",15,"Europe_Non_EU","1976",61121390,30249566,30871827,61121393,-3
"396",15,"Europe_Non_EU","1977",62196164,30832481,31363681,62196162,2
"397",15,"Europe_Non_EU","1978",63282121,31412050,31870070,63282120,1
"398",15,"Europe_Non_EU","1979",64343839,31981670,32362170,64343840,-1
"399",15,"Europe_Non_EU","1980",65402299,32535194,32867104,65402298,1
"400",15,"Europe_Non_EU","1981",66475057,33081103,33393954,66475057,0
"401",15,"Europe_Non_EU","1982",67627792,33666200,33961591,67627791,1
"402",15,"Europe_Non_EU","1983",68878107,34299902,34578205,68878107,0
"403",15,"Europe_Non_EU","1984",70119641,34929862,35189779,70119641,0
"404",15,"Europe_Non_EU","1985",71336060,35547545,35788515,71336060,0
"405",15,"Europe_Non_EU","1986",72537977,36158430,36379548,72537978,-1
"406",15,"Europe_Non_EU","1987",73703043,36750723,36952321,73703044,-1
"407",15,"Europe_Non_EU","1988",74848098,37333566,37514534,74848100,-2
"408",15,"Europe_Non_EU","1989",76008664,37924727,38083938,76008665,-1
"409",15,"Europe_Non_EU","1990",77118908,38492334,38626573,77118907,1
"410",15,"Europe_Non_EU","1991",78018797,38957346,39061452,78018798,-1
"411",15,"Europe_Non_EU","1992",78673587,39309173,39364414,78673587,0
"412",15,"Europe_Non_EU","1993",79373109,39690639,39682464,79373103,6
"413",15,"Europe_Non_EU","1994",80260621,40159457,40101167,80260624,-3
"414",15,"Europe_Non_EU","1995",81084864,40584820,40500043,81084863,1
"415",15,"Europe_Non_EU","1996",82149690,41128697,41020992,82149689,1
"416",15,"Europe_Non_EU","1997",83211265,41671276,41539990,83211266,-1
"417",15,"Europe_Non_EU","1998",84200858,42176522,42024338,84200860,-2
"418",15,"Europe_Non_EU","1999",85123548,42647827,42475723,85123550,-2
"419",15,"Europe_Non_EU","2000",85997872,43094876,42902995,85997871,1
"420",15,"Europe_Non_EU","2001",86772469,43487019,43285452,86772471,-2
"421",15,"Europe_Non_EU","2002",87666764,43938617,43728145,87666762,2
"422",15,"Europe_Non_EU","2003",88513730,44364012,44149718,88513730,0
"423",15,"Europe_Non_EU","2004",89368528,44792310,44576218,89368528,0
"424",15,"Europe_Non_EU","2005",90212529,45215308,44997223,90212531,-2
"425",15,"Europe_Non_EU","2006",91029947,45625343,45404603,91029946,1
"426",15,"Europe_Non_EU","2007",91797992,46010005,45787986,91797991,1
"427",15,"Europe_Non_EU","2008",92535226,46378642,46156584,92535226,0
"428",15,"Europe_Non_EU","2009",93325861,46774043,46551819,93325862,-1
"429",15,"Europe_Non_EU","2010",94180749,47201231,46979519,94180750,-1
"430",15,"Europe_Non_EU","2011",95015530,47618314,47397218,95015532,-2
"431",15,"Europe_Non_EU","2012",96000494,48111519,47888972,96000491,3
"432",15,"Europe_Non_EU","2013",97193828,48707303,48486525,97193828,0
"433",15,"Europe_Non_EU","2014",98630491,49422553,49207938,98630491,0
"434",15,"Europe_Non_EU","2015",100042577,50125538,49917040,100042578,-1
"435",15,"Europe_Non_EU","2016",101303945,50755940,50548004,101303944,1
"436",15,"Europe_Non_EU","2017",102245574,51227382,51018192,102245574,0
"437",15,"Europe_Non_EU","2018",102844700,51528061,51316638,102844699,1
"438",15,"Europe_Non_EU","2019",103405796,51811738,51594057,103405795,1
"439",15,"Europe_Non_EU","2020",103932327,52083691,51848634,103932325,2
"440",15,"Europe_Non_EU","2021",104255642,52255753,51999888,104255641,1
"441",15,"Europe_Non_EU","2022",104638326,52456570,52181755,104638325,1
"442",16,"European Free Trade Association","1960",9101112,4639135,4461979,9101114,-2
"443",16,"European Free Trade Association","1961",9239957,4708069,4531888,9239957,0
"444",16,"European Free Trade Association","1962",9412332,4792645,4619687,9412332,0
"445",16,"European Free Trade Association","1963",9564062,4866632,4697430,9564062,0
"446",16,"European Free Trade Association","1964",9690608,4928302,4762307,9690609,-1
"447",16,"European Free Trade Association","1965",9790426,4976929,4813497,9790426,0
"448",16,"European Free Trade Association","1966",9885541,5023784,4861758,9885542,-1
"449",16,"European Free Trade Association","1967",9994542,5077524,4917018,9994542,0
"450",16,"European Free Trade Association","1968",10105699,5132167,4973533,10105700,-1
"451",16,"European Free Trade Association","1969",10208021,5183004,5025017,10208021,0
"452",16,"European Free Trade Association","1970",10282167,5220918,5061248,10282166,1
"453",16,"European Free Trade Association","1971",10344053,5252951,5091102,10344053,0
"454",16,"European Free Trade Association","1972",10424970,5294830,5130141,10424971,-1
"455",16,"European Free Trade Association","1973",10502527,5336720,5165807,10502527,0
"456",16,"European Free Trade Association","1974",10564510,5370950,5193560,10564510,0
"457",16,"European Free Trade Association","1975",10586954,5385179,5201776,10586955,-1
"458",16,"European Free Trade Association","1976",10572226,5380644,5191583,10572227,-1
"459",16,"European Free Trade Association","1977",10569981,5382121,5187858,10569979,2
"460",16,"European Free Trade Association","1978",10588151,5393805,5194346,10588151,0
"461",16,"European Free Trade Association","1979",10617233,5410173,5207060,10617233,0
"462",16,"European Free Trade Association","1980",10658169,5431896,5226274,10658170,-1
"463",16,"European Free Trade Association","1981",10709877,5458513,5251363,10709876,1
"464",16,"European Free Trade Association","1982",10765645,5486548,5279097,10765645,0
"465",16,"European Free Trade Association","1983",10810237,5509200,5301037,10810237,0
"466",16,"European Free Trade Association","1984",10847895,5528586,5319310,10847896,-1
"467",16,"European Free Trade Association","1985",10891071,5550228,5340843,10891071,0
"468",16,"European Free Trade Association","1986",10941817,5575709,5366110,10941819,-2
"469",16,"European Free Trade Association","1987",11005412,5607128,5398285,11005413,-1
"470",16,"European Free Trade Association","1988",11080558,5643497,5437058,11080555,3
"471",16,"European Free Trade Association","1989",11155022,5679795,5475227,11155022,0
"472",16,"European Free Trade Association","1990",11240583,5721447,5519135,11240582,1
"473",16,"European Free Trade Association","1991",11348675,5775645,5573031,11348676,-1
"474",16,"European Free Trade Association","1992",11452403,5828475,5623928,11452403,0
"475",16,"European Free Trade Association","1993",11543993,5874730,5669262,11543992,1
"476",16,"European Free Trade Association","1994",11626876,5917099,5709776,11626875,1
"477",16,"European Free Trade Association","1995",11698229,5954034,5744195,11698229,0
"478",16,"European Free Trade Association","1996",11753439,5982832,5770607,11753439,0
"479",16,"European Free Trade Association","1997",11796961,6004777,5792182,11796959,2
"480",16,"European Free Trade Association","1998",11847702,6029749,5817951,11847700,2
"481",16,"European Free Trade Association","1999",11915900,6062475,5853425,11915900,0
"482",16,"European Free Trade Association","2000",11989448,6097503,5891945,11989448,0
"483",16,"European Free Trade Association","2001",12061949,6133246,5928702,12061948,1
"484",16,"European Free Trade Association","2002",12144128,6173527,5970601,12144128,0
"485",16,"European Free Trade Association","2003",12227377,6213399,6013979,12227378,-1
"486",16,"European Free Trade Association","2004",12307909,6251481,6056427,12307908,1
"487",16,"European Free Trade Association","2005",12391743,6290241,6101502,12391743,0
"488",16,"European Free Trade Association","2006",12483282,6330640,6152643,12483283,-1
"489",16,"European Free Trade Association","2007",12606986,6383076,6223908,12606984,2
"490",16,"European Free Trade Association","2008",12768702,6453538,6315163,12768701,1
"491",16,"European Free Trade Association","2009",12926731,6526682,6400049,12926731,0
"492",16,"European Free Trade Association","2010",13068128,6593078,6475050,13068128,0
"493",16,"European Free Trade Association","2011",13220689,6662688,6558003,13220691,-2
"494",16,"European Free Trade Association","2012",13372655,6730718,6641937,13372655,0
"495",16,"European Free Trade Association","2013",13529539,6802054,6727485,13529539,0
"496",16,"European Free Trade Association","2014",13690363,6876561,6813803,13690364,-1
"497",16,"European Free Trade Association","2015",13839173,6945301,6893872,13839173,0
"498",16,"European Free Trade Association","2016",13980905,7009219,6971685,13980904,1
"499",16,"European Free Trade Association","2017",14110097,7068185,7041913,14110098,-1
"500",16,"European Free Trade Association","2018",14217147,7119379,7097768,14217147,0
"501",16,"European Free Trade Association","2019",14322221,7169336,7152886,14322222,-1
"502",16,"European Free Trade Association","2020",14422861,7216940,7205924,14422864,-3
"503",16,"European Free Trade Association","2021",14523284,7264810,7258473,14523283,1
"504",16,"European Free Trade Association","2022",14648095,7324271,7323823,14648094,1
"505",17,"India","1960",445954579,215819000,230135579,445954579,0
"506",17,"India","1961",456351876,220791299,235560577,456351876,0
"507",17,"India","1962",467024193,225898332,241125862,467024194,-1
"508",17,"India","1963",477933619,231120329,246813291,477933620,-1
"509",17,"India","1964",489059309,236446379,252612930,489059309,0
"510",17,"India","1965",500114346,241740859,258373487,500114346,0
"511",17,"India","1966",510992617,246951009,264041608,510992617,0
"512",17,"India","1967",521987069,252216091,269770979,521987070,-1
"513",17,"India","1968",533431909,257695427,275736482,533431909,0
"514",17,"India","1969",545314670,263380464,281934206,545314670,0
"515",17,"India","1970",557501301,269208897,288292405,557501302,-1
"516",17,"India","1971",569999178,275180236,294818942,569999178,0
"517",17,"India","1972",582837973,281308597,301529376,582837973,0
"518",17,"India","1973",596107483,287642024,308465459,596107483,0
"519",17,"India","1974",609721951,294137889,315584063,609721952,-1
"520",17,"India","1975",623524219,300723268,322800952,623524220,-1
"521",17,"India","1976",637451448,307373867,330077580,637451447,1
"522",17,"India","1977",651685628,314189303,337496325,651685628,0
"523",17,"India","1978",666267760,321198151,345069608,666267759,1
"524",17,"India","1979",681248383,328422054,352826329,681248383,0
"525",17,"India","1980",696828385,335953058,360875327,696828385,0
"526",17,"India","1981",712869298,343719452,369149846,712869298,0
"527",17,"India","1982",729169466,351626946,377542519,729169465,1
"528",17,"India","1983",745826546,359724278,386102269,745826547,-1
"529",17,"India","1984",762895156,368029660,394865497,762895157,-1
"530",17,"India","1985",780242084,376475662,403766421,780242083,1
"531",17,"India","1986",797878993,385067312,412811682,797878994,-1
"532",17,"India","1987",815716125,393755601,421960524,815716125,0
"533",17,"India","1988",833729681,402535292,431194389,833729681,0
"534",17,"India","1989",852012673,411461378,440551295,852012673,0
"535",17,"India","1990",870452165,420468106,449984059,870452165,0
"536",17,"India","1991",888941756,429478264,459463492,888941756,0
"537",17,"India","1992",907574049,438527953,469046096,907574049,0
"538",17,"India","1993",926351297,447615320,478735976,926351296,1
"539",17,"India","1994",945261958,456726553,488535405,945261958,0
"540",17,"India","1995",964279129,465846665,498432465,964279130,-1
"541",17,"India","1996",983281218,474932057,508349160,983281217,1
"542",17,"India","1997",1002335230,484031612,518303618,1002335230,0
"543",17,"India","1998",1021434576,493147162,528287413,1021434575,1
"544",17,"India","1999",1040500054,502255693,538244360,1040500053,1
"545",17,"India","2000",1059633675,511410095,548223581,1059633676,-1
"546",17,"India","2001",1078970907,520679574,558291332,1078970906,1
"547",17,"India","2002",1098313039,529978166,568334873,1098313039,0
"548",17,"India","2003",1117415123,539178882,578236241,1117415123,0
"549",17,"India","2004",1136264583,548274218,587990365,1136264583,0
"550",17,"India","2005",1154638713,557161047,597477666,1154638713,0
"551",17,"India","2006",1172373788,565762395,606611392,1172373787,1
"552",17,"India","2007",1189691809,574185530,615506279,1189691809,0
"553",17,"India","2008",1206734806,582492785,624242020,1206734805,1
"554",17,"India","2009",1223640160,590747758,632892402,1223640160,0
"555",17,"India","2010",1240613620,599047591,641566029,1240613620,0
"556",17,"India","2011",1257621191,607376801,650244390,1257621191,0
"557",17,"India","2012",1274487215,615647779,658839435,1274487214,1
"558",17,"India","2013",1291132063,623809180,667322883,1291132063,0
"559",17,"India","2014",1307246509,631697152,675549357,1307246509,0
"560",17,"India","2015",1322866505,639323292,683543213,1322866505,0
"561",17,"India","2016",1338636340,647012921,691623419,1338636340,0
"562",17,"India","2017",1354195680,654607791,699587889,1354195680,0
"563",17,"India","2018",1369003306,661854076,707149230,1369003306,0
"564",17,"India","2019",1383112050,668786993,714325057,1383112050,0
"565",17,"India","2020",1396387127,675389679,720997448,1396387127,0
"566",17,"India","2021",1407563842,681060412,726503429,1407563841,1
"567",17,"India","2022",1417173173,685992675,731180498,1417173173,0
"568",18,"Indonesia","1960",88382881,44298836,44084045,88382881,0
"569",18,"Indonesia","1961",90816938,45505228,45311709,90816937,1
"570",18,"Indonesia","1962",93345489,46755916,46589573,93345489,0
"571",18,"Indonesia","1963",95962527,48049423,47913104,95962527,0
"572",18,"Indonesia","1964",98675061,49393533,49281528,98675061,0
"573",18,"Indonesia","1965",101157868,50670788,50487080,101157868,0
"574",18,"Indonesia","1966",103561105,51914171,51646935,103561106,-1
"575",18,"Indonesia","1967",106260749,53261620,52999128,106260748,1
"576",18,"Indonesia","1968",109138723,54693876,54444848,109138724,-1
"577",18,"Indonesia","1969",112149246,56192696,55956550,112149246,0
"578",18,"Indonesia","1970",115228394,57726007,57502387,115228394,0
"579",18,"Indonesia","1971",118347135,59280005,59067130,118347135,0
"580",18,"Indonesia","1972",121504145,60852641,60651504,121504145,0
"581",18,"Indonesia","1973",124709058,62447954,62261105,124709059,-1
"582",18,"Indonesia","1974",127945196,64057961,63887234,127945195,1
"583",18,"Indonesia","1975",131213215,65683015,65530199,131213214,1
"584",18,"Indonesia","1976",134521025,67328209,67192815,134521024,1
"585",18,"Indonesia","1977",137861540,68989822,68871718,137861540,0
"586",18,"Indonesia","1978",141250964,70673511,70577452,141250963,1
"587",18,"Indonesia","1979",144693087,72379110,72313976,144693086,1
"588",18,"Indonesia","1980",148177096,74102204,74074893,148177097,-1
"589",18,"Indonesia","1981",151686337,75833339,75852998,151686337,0
"590",18,"Indonesia","1982",155228658,77575448,77653209,155228657,1
"591",18,"Indonesia","1983",158790611,79326498,79464113,158790611,0
"592",18,"Indonesia","1984",162331962,81064901,81267061,162331962,0
"593",18,"Indonesia","1985",165791694,82758996,83032697,165791693,1
"594",18,"Indonesia","1986",169135273,84396961,84738312,169135273,0
"595",18,"Indonesia","1987",172421390,86004739,86416651,172421390,0
"596",18,"Indonesia","1988",175694647,87604902,88089745,175694647,0
"597",18,"Indonesia","1989",178949174,89198541,89750633,178949174,0
"598",18,"Indonesia","1990",182159874,90771091,91388784,182159875,-1
"599",18,"Indonesia","1991",185361228,92335803,93025425,185361228,0
"600",18,"Indonesia","1992",188558416,93896001,94662415,188558416,0
"601",18,"Indonesia","1993",191737287,95452746,96284542,191737288,-1
"602",18,"Indonesia","1994",194928533,97016958,97911576,194928534,-1
"603",18,"Indonesia","1995",198140162,98589133,99551030,198140163,-1
"604",18,"Indonesia","1996",201373791,100173076,101200715,201373791,0
"605",18,"Indonesia","1997",204628007,101769000,102859007,204628007,0
"606",18,"Indonesia","1998",207855486,103351567,104503918,207855485,1
"607",18,"Indonesia","1999",210996910,104895341,106101569,210996910,0
"608",18,"Indonesia","2000",214072421,106407480,107664942,214072422,-1
"609",18,"Indonesia","2001",217112437,107901551,109210886,217112437,0
"610",18,"Indonesia","2002",220115092,109376745,110738346,220115091,1
"611",18,"Indonesia","2003",223080121,110834579,112245542,223080121,0
"612",18,"Indonesia","2004",225938595,112236510,113702084,225938594,1
"613",18,"Indonesia","2005",228805144,113637675,115167468,228805143,1
"614",18,"Indonesia","2006",231797427,115112096,116685330,231797426,1
"615",18,"Indonesia","2007",234858289,116621886,118236404,234858290,-1
"616",18,"Indonesia","2008",237936543,118134983,119801561,237936544,-1
"617",18,"Indonesia","2009",240981299,119636496,121344803,240981299,0
"618",18,"Indonesia","2010",244016173,121133510,122882663,244016173,0
"619",18,"Indonesia","2011",247099697,122648363,124451334,247099697,0
"620",18,"Indonesia","2012",250222695,124183204,126039491,250222695,0
"621",18,"Indonesia","2013",253275918,125693504,127582414,253275918,0
"622",18,"Indonesia","2014",256229761,127158711,129071050,256229761,0
"623",18,"Indonesia","2015",259091970,128574643,130517327,259091970,0
"624",18,"Indonesia","2016",261850182,129940374,131909809,261850183,-1
"625",18,"Indonesia","2017",264498852,131253454,133245399,264498853,-1
"626",18,"Indonesia","2018",267066843,132530163,134536680,267066843,0
"627",18,"Indonesia","2019",269582878,133784436,135798442,269582878,0
"628",18,"Indonesia","2020",271857970,134930389,136927582,271857971,-1
"629",18,"Indonesia","2021",273753191,135900714,137852478,273753192,-1
"630",18,"Indonesia","2022",275501339,136798063,138703277,275501340,-1
"631",19,"Japan","1960",93216000,47434416,45781584,93216000,0
"632",19,"Japan","1961",94055000,47855063,46199936,94054999,1
"633",19,"Japan","1962",94933000,48294311,46638689,94933000,0
"634",19,"Japan","1963",95900000,48778588,47121412,95900000,0
"635",19,"Japan","1964",96903000,49279989,47623010,96902999,1
"636",19,"Japan","1965",97952000,49804697,48147303,97952000,0
"637",19,"Japan","1966",98851000,50254891,48596109,98851000,0
"638",19,"Japan","1967",99879000,50768868,49110132,99879000,0
"639",19,"Japan","1968",101011000,51330606,49680393,101010999,1
"640",19,"Japan","1969",102219000,51928754,50290247,102219001,-1
"641",19,"Japan","1970",103403000,52513428,50889572,103403000,0
"642",19,"Japan","1971",105697000,53660202,52036797,105696999,1
"643",19,"Japan","1972",107188000,54398884,52789115,107187999,1
"644",19,"Japan","1973",108707000,55150574,53556426,108707000,0
"645",19,"Japan","1974",110162000,55868603,54293397,110162000,0
"646",19,"Japan","1975",111573000,56567115,55005885,111573000,0
"647",19,"Japan","1976",112775000,57165192,55609808,112775000,0
"648",19,"Japan","1977",113872000,57714402,56157599,113872001,-1
"649",19,"Japan","1978",114913000,58239277,56673723,114913000,0
"650",19,"Japan","1979",115890000,58735700,57154300,115890000,0
"651",19,"Japan","1980",116807000,59206049,57600950,116806999,1
"652",19,"Japan","1981",117661000,59648209,58012790,117660999,1
"653",19,"Japan","1982",118480000,60074308,58405692,118480000,0
"654",19,"Japan","1983",119307000,60505995,58801004,119306999,1
"655",19,"Japan","1984",120083000,60913170,59169830,120083000,0
"656",19,"Japan","1985",120837000,61309541,59527459,120837000,0
"657",19,"Japan","1986",121482000,61650870,59831130,121482000,0
"658",19,"Japan","1987",122069000,61963243,60105757,122069000,0
"659",19,"Japan","1988",122578000,62236126,60341874,122578000,0
"660",19,"Japan","1989",123069000,62501517,60567483,123069000,0
"661",19,"Japan","1990",123478000,62728216,60749784,123478000,0
"662",19,"Japan","1991",123964000,62995976,60968023,123963999,1
"663",19,"Japan","1992",124425000,63252136,61172864,124425000,0
"664",19,"Japan","1993",124829000,63480813,61348187,124829000,0
"665",19,"Japan","1994",125178000,63683139,61494860,125177999,1
"666",19,"Japan","1995",125472000,63859897,61612103,125472000,0
"667",19,"Japan","1996",125757000,64033555,61723445,125757000,0
"668",19,"Japan","1997",126057000,64215271,61841728,126056999,1
"669",19,"Japan","1998",126400000,64422022,61977978,126400000,0
"670",19,"Japan","1999",126631000,64573919,62057082,126631001,-1
"671",19,"Japan","2000",126843000,64716290,62126711,126843001,-1
"672",19,"Japan","2001",127149000,64907199,62241801,127149000,0
"673",19,"Japan","2002",127445000,65093948,62351052,127445000,0
"674",19,"Japan","2003",127718000,65270637,62447363,127718000,0
"675",19,"Japan","2004",127761000,65330634,62430367,127761001,-1
"676",19,"Japan","2005",127773000,65374871,62398129,127773000,0
"677",19,"Japan","2006",127854000,65451729,62402271,127854000,0
"678",19,"Japan","2007",128001000,65557955,62443045,128001000,0
"679",19,"Japan","2008",128063000,65618491,62444510,128063001,-1
"680",19,"Japan","2009",128047000,65637199,62409801,128047000,0
"681",19,"Japan","2010",128070000,65672237,62397763,128070000,0
"682",19,"Japan","2011",127833000,65569426,62263573,127832999,1
"683",19,"Japan","2012",127629000,65480007,62148992,127628999,1
"684",19,"Japan","2013",127445000,65398896,62046104,127445000,0
"685",19,"Japan","2014",127276000,65324683,61951317,127276000,0
"686",19,"Japan","2015",127141000,65267090,61873910,127141000,0
"687",19,"Japan","2016",127076000,65245704,61830297,127076001,-1
"688",19,"Japan","2017",126972000,65206949,61765051,126972000,0
"689",19,"Japan","2018",126811000,65140618,61670382,126811000,0
"690",19,"Japan","2019",126633000,65065286,61567714,126633000,0
"691",19,"Japan","2020",126261000,64885399,61375600,126260999,1
"692",19,"Japan","2021",125681593,64594414,61087180,125681594,-1
"693",19,"Japan","2022",125124989,64314912,60810077,125124989,0
"694",2,"Africa_Eastern","1960",63950984,32071728,31879252,63950980,4
"695",2,"Africa_Eastern","1961",65694131,32956286,32737850,65694136,-5
"696",2,"Africa_Eastern","1962",67531188,33887057,33644131,67531188,0
"697",2,"Africa_Eastern","1963",69424759,34848821,34575937,69424758,1
"698",2,"Africa_Eastern","1964",71435749,35869877,35565868,71435745,4
"699",2,"Africa_Eastern","1965",73543437,36938663,36604772,73543435,2
"700",2,"Africa_Eastern","1966",75665648,38018019,37647629,75665648,0
"701",2,"Africa_Eastern","1967",77862795,39135959,38726839,77862798,-3
"702",2,"Africa_Eastern","1968",80172533,40309638,39862894,80172532,1
"703",2,"Africa_Eastern","1969",82546767,41516035,41030732,82546767,0
"704",2,"Africa_Eastern","1970",84986568,42754875,42231692,84986567,1
"705",2,"Africa_Eastern","1971",87485192,44021649,43463544,87485193,-1
"706",2,"Africa_Eastern","1972",89920165,45257976,44662187,89920163,2
"707",2,"Africa_Eastern","1973",92417096,46521688,45895411,92417099,-3
"708",2,"Africa_Eastern","1974",95120337,47875248,47245091,95120339,-2
"709",2,"Africa_Eastern","1975",97897093,49257364,48639730,97897094,-1
"710",2,"Africa_Eastern","1976",100766682,50686977,50079704,100766681,1
"711",2,"Africa_Eastern","1977",103567622,52081398,51486224,103567622,0
"712",2,"Africa_Eastern","1978",106621244,53601529,53019715,106621244,0
"713",2,"Africa_Eastern","1979",109954382,55259731,54694650,109954381,1
"714",2,"Africa_Eastern","1980",112959439,56750955,56208485,112959440,-1
"715",2,"Africa_Eastern","1981",116305076,58417105,57887971,116305076,0
"716",2,"Africa_Eastern","1982",120155559,60344924,59810639,120155563,-4
"717",2,"Africa_Eastern","1983",123763987,62171433,61592554,123763987,0
"718",2,"Africa_Eastern","1984",127235555,63932071,63303488,127235559,-4
"719",2,"Africa_Eastern","1985",130840501,65741566,65098935,130840501,0
"720",2,"Africa_Eastern","1986",134634956,67637112,66997841,134634953,3
"721",2,"Africa_Eastern","1987",138660320,69652928,69007392,138660320,0
"722",2,"Africa_Eastern","1988",142473937,71581705,70892228,142473933,4
"723",2,"Africa_Eastern","1989",146219497,73471356,72748140,146219496,1
"724",2,"Africa_Eastern","1990",150371315,75549247,74822072,150371319,-4
"725",2,"Africa_Eastern","1991",154587251,77645199,76942050,154587249,2
"726",2,"Africa_Eastern","1992",158739828,79710542,79029287,158739829,-1
"727",2,"Africa_Eastern","1993",163082014,81898486,81183529,163082015,-1
"728",2,"Africa_Eastern","1994",166692793,83743626,82949169,166692795,-2
"729",2,"Africa_Eastern","1995",170721162,85793154,84928012,170721166,-4
"730",2,"Africa_Eastern","1996",176483036,88697343,87785693,176483036,0
"731",2,"Africa_Eastern","1997",182234935,91588682,90646252,182234934,1
"732",2,"Africa_Eastern","1998",187491938,94233774,93258166,187491940,-2
"733",2,"Africa_Eastern","1999",192888951,96952773,95936179,192888952,-1
"734",2,"Africa_Eastern","2000",198531471,99771564,98759905,198531469,2
"735",2,"Africa_Eastern","2001",204365811,102672109,101693708,204365817,-6
"736",2,"Africa_Eastern","2002",210399048,105670054,104728991,210399045,3
"737",2,"Africa_Eastern","2003",216626770,108759344,107867426,216626770,0
"738",2,"Africa_Eastern","2004",223051761,111944395,111107363,223051758,3
"739",2,"Africa_Eastern","2005",229620935,115204880,114416058,229620938,-3
"740",2,"Africa_Eastern","2006",236381237,118561014,117820219,236381233,4
"741",2,"Africa_Eastern","2007",243430488,122062823,121367666,243430489,-1
"742",2,"Africa_Eastern","2008",250723821,125691748,125032070,250723818,3
"743",2,"Africa_Eastern","2009",258185076,129409472,128775604,258185076,0
"744",2,"Africa_Eastern","2010",265718454,133166600,132551855,265718455,-1
"745",2,"Africa_Eastern","2011",273076001,136838943,136237055,273075998,3
"746",2,"Africa_Eastern","2012",280501484,140548514,139952970,280501484,0
"747",2,"Africa_Eastern","2013",288164964,144380986,143783978,288164964,0
"748",2,"Africa_Eastern","2014",295808604,148208770,147599834,295808604,0
"749",2,"Africa_Eastern","2015",303490501,152058538,151431964,303490502,-1
"750",2,"Africa_Eastern","2016",311407012,156027773,155379242,311407015,-3
"751",2,"Africa_Eastern","2017",319494638,160081986,159412651,319494637,1
"752",2,"Africa_Eastern","2018",327819902,164255926,163563977,327819903,-1
"753",2,"Africa_Eastern","2019",336554966,168633503,167921464,336554967,-1
"754",2,"Africa_Eastern","2020",345475001,173103467,172371530,345474997,4
"755",2,"Africa_Eastern","2021",354356055,177564634,176791419,354356053,2
"756",2,"Africa_Eastern","2022",363224041,182022780,181201256,363224036,5
"757",20,"Mexico","1960",36268055,18028913,18239142,36268055,0
"758",20,"Mexico","1961",37439317,18616799,18822518,37439317,0
"759",20,"Mexico","1962",38683283,19240634,19442648,38683282,1
"760",20,"Mexico","1963",39982118,19891387,20090731,39982118,0
"761",20,"Mexico","1964",41333878,20568063,20765815,41333878,0
"762",20,"Mexico","1965",42737991,21270482,21467510,42737992,-1
"763",20,"Mexico","1966",44180437,21991752,22188685,44180437,0
"764",20,"Mexico","1967",45656963,22729882,22927082,45656964,-1
"765",20,"Mexico","1968",47170337,23486454,23683883,47170337,0
"766",20,"Mexico","1969",48714394,24258520,24455874,48714394,0
"767",20,"Mexico","1970",50289306,25046519,25242786,50289305,1
"768",20,"Mexico","1971",51897675,25870987,26026688,51897675,0
"769",20,"Mexico","1972",53543436,26731631,26811805,53543436,0
"770",20,"Mexico","1973",55228203,27609964,27618239,55228203,0
"771",20,"Mexico","1974",56945880,28506368,28439513,56945881,-1
"772",20,"Mexico","1975",58691882,29419648,29272233,58691881,1
"773",20,"Mexico","1976",60452543,30346083,30106460,60452543,0
"774",20,"Mexico","1977",62262505,31291999,30970506,62262505,0
"775",20,"Mexico","1978",64123997,32255984,31868013,64123997,0
"776",20,"Mexico","1979",65972912,33217040,32755872,65972912,0
"777",20,"Mexico","1980",67705186,34120789,33584396,67705185,1
"778",20,"Mexico","1981",69233769,34922848,34310921,69233769,0
"779",20,"Mexico","1982",70656783,35672570,34984213,70656783,0
"780",20,"Mexico","1983",72080310,36422094,35658215,72080309,1
"781",20,"Mexico","1984",73489654,37164338,36325315,73489653,1
"782",20,"Mexico","1985",74872006,37893236,36978770,74872006,0
"783",20,"Mexico","1986",76224365,38607741,37616624,76224365,0
"784",20,"Mexico","1987",77553504,39311370,38242134,77553504,0
"785",20,"Mexico","1988",78892015,40019226,38872789,78892015,0
"786",20,"Mexico","1989",80233749,40728948,39504800,80233748,1
"787",20,"Mexico","1990",81720428,41509560,40210868,81720428,0
"788",20,"Mexico","1991",83351595,42363669,40987927,83351596,-1
"789",20,"Mexico","1992",84993164,43224989,41768175,84993164,0
"790",20,"Mexico","1993",86648447,44092387,42556060,86648447,0
"791",20,"Mexico","1994",88314424,44964382,43350041,88314423,1
"792",20,"Mexico","1995",89969572,45831232,44138340,89969572,0
"793",20,"Mexico","1996",91586555,46680349,44906205,91586554,1
"794",20,"Mexico","1997",93183094,47517728,45665366,93183094,0
"795",20,"Mexico","1998",94767284,48346692,46420593,94767285,-1
"796",20,"Mexico","1999",96334810,49166531,47168279,96334810,0
"797",20,"Mexico","2000",97873442,49973382,47900060,97873442,0
"798",20,"Mexico","2001",99394288,50758748,48635540,99394288,0
"799",20,"Mexico","2002",100917081,51530724,49386357,100917081,0
"800",20,"Mexico","2003",102429341,52296746,50132595,102429341,0
"801",20,"Mexico","2004",103945813,53064573,50881240,103945813,0
"802",20,"Mexico","2005",105442402,53823103,51619299,105442402,0
"803",20,"Mexico","2006",106886790,54557092,52329698,106886790,0
"804",20,"Mexico","2007",108302973,55278659,53024314,108302973,0
"805",20,"Mexico","2008",109684489,55985191,53699298,109684489,0
"806",20,"Mexico","2009",111049428,56685733,54363696,111049429,-1
"807",20,"Mexico","2010",112532401,57445993,55086407,112532400,1
"808",20,"Mexico","2011",114150481,58268408,55882073,114150481,0
"809",20,"Mexico","2012",115755909,59081795,56674115,115755910,-1
"810",20,"Mexico","2013",117290686,59862821,57427865,117290686,0
"811",20,"Mexico","2014",118755887,60610526,58145362,118755888,-1
"812",20,"Mexico","2015",120149897,61325120,58824776,120149896,1
"813",20,"Mexico","2016",121519221,62029592,59489629,121519221,0
"814",20,"Mexico","2017",122839258,62712641,60126616,122839257,1
"815",20,"Mexico","2018",124013861,63328698,60685164,124013862,-1
"816",20,"Mexico","2019",125085311,63898082,61187228,125085310,1
"817",20,"Mexico","2020",125998302,64410851,61587451,125998302,0
"818",20,"Mexico","2021",126705138,64849001,61856137,126705138,0
"819",20,"Mexico","2022",127504125,65309171,62194954,127504125,0
"820",21,"Middle East","1960",48724736,23956610,24768127,48724737,-1
"821",21,"Middle East","1961",50112934,24631593,25481339,50112932,2
"822",21,"Middle East","1962",51636041,25372329,26263716,51636045,-4
"823",21,"Middle East","1963",53228077,26147126,27080952,53228078,-1
"824",21,"Middle East","1964",54908940,26964248,27944696,54908944,-4
"825",21,"Middle East","1965",56665460,27815931,28849527,56665458,2
"826",21,"Middle East","1966",58471300,28693485,29777812,58471297,3
"827",21,"Middle East","1967",60390192,29628987,30761204,60390191,1
"828",21,"Middle East","1968",62332471,30571381,31761088,62332469,2
"829",21,"Middle East","1969",64388972,31565094,32823879,64388973,-1
"830",21,"Middle East","1970",66555339,32609224,33946118,66555342,-3
"831",21,"Middle East","1971",68791585,33681163,35110419,68791582,3
"832",21,"Middle East","1972",71091959,34777866,36314091,71091957,2
"833",21,"Middle East","1973",73539936,35945439,37594497,73539936,0
"834",21,"Middle East","1974",76061724,37148894,38912829,76061723,1
"835",21,"Middle East","1975",78664892,38371277,40293617,78664894,-2
"836",21,"Middle East","1976",81680259,39779140,41901120,81680260,-1
"837",21,"Middle East","1977",84848160,41254275,43593884,84848159,1
"838",21,"Middle East","1978",87513550,42469607,45043943,87513550,0
"839",21,"Middle East","1979",90338890,43767129,46571761,90338890,0
"840",21,"Middle East","1980",93673665,45329041,48344627,93673668,-3
"841",21,"Middle East","1981",97665486,47162413,50503074,97665487,-1
"842",21,"Middle East","1982",101722097,49060876,52661216,101722092,5
"843",21,"Middle East","1983",105390822,50856663,54534155,105390818,4
"844",21,"Middle East","1984",109240198,52730791,56509406,109240197,1
"845",21,"Middle East","1985",113121390,54605916,58515476,113121392,-2
"846",21,"Middle East","1986",117117439,56534348,60583096,117117444,-5
"847",21,"Middle East","1987",121222234,58518261,62703972,121222233,1
"848",21,"Middle East","1988",125246010,60457950,64788061,125246011,-1
"849",21,"Middle East","1989",129344404,62422705,66921700,129344405,-1
"850",21,"Middle East","1990",135292131,65322768,69969361,135292129,2
"851",21,"Middle East","1991",139755598,67463394,72292206,139755600,-2
"852",21,"Middle East","1992",144275955,69593937,74682012,144275949,6
"853",21,"Middle East","1993",147849640,71265503,76584140,147849643,-3
"854",21,"Middle East","1994",151206497,72838734,78367763,151206497,0
"855",21,"Middle East","1995",154876763,74586874,80289890,154876764,-1
"856",21,"Middle East","1996",158542143,76340768,82201375,158542143,0
"857",21,"Middle East","1997",162302500,78137192,84165307,162302499,1
"858",21,"Middle East","1998",166140801,79970469,86170336,166140805,-4
"859",21,"Middle East","1999",170088143,81860821,88227322,170088143,0
"860",21,"Middle East","2000",174156820,83813578,90343243,174156821,-1
"861",21,"Middle East","2001",178276755,85791208,92485549,178276757,-2
"862",21,"Middle East","2002",181944308,87543365,94400944,181944309,-1
"863",21,"Middle East","2003",185593447,89261903,96331544,185593447,0
"864",21,"Middle East","2004",189779758,91232086,98547675,189779761,-3
"865",21,"Middle East","2005",194537443,93406775,101130673,194537448,-5
"866",21,"Middle East","2006",200027043,95774827,104252216,200027043,0
"867",21,"Middle East","2007",205940095,98244462,107695636,205940098,-3
"868",21,"Middle East","2008",212043717,100784032,111259687,212043719,-2
"869",21,"Middle East","2009",218134116,103372572,114761542,218134114,2
"870",21,"Middle East","2010",223703177,105870558,117832615,223703173,4
"871",21,"Middle East","2011",228824290,108262151,120562139,228824290,0
"872",21,"Middle East","2012",233845917,110606575,123239344,233845919,-2
"873",21,"Middle East","2013",238925141,112973817,125951324,238925141,0
"874",21,"Middle East","2014",244113127,115389779,128723352,244113131,-4
"875",21,"Middle East","2015",249357736,117718802,131638929,249357731,5
"876",21,"Middle East","2016",254240306,119838998,134401307,254240305,1
"877",21,"Middle East","2017",258733503,121910992,136822508,258733500,3
"878",21,"Middle East","2018",263525545,124213256,139312288,263525544,1
"879",21,"Middle East","2019",268376870,126621885,141754988,268376873,-3
"880",21,"Middle East","2020",271939924,128592714,143347211,271939925,-1
"881",21,"Middle East","2021",275029016,130344376,144684642,275029018,-2
"882",21,"Middle East","2022",279100850,132429874,146670975,279100849,1
"883",22,"Pakistan","1960",45954226,21159049,24795178,45954227,-1
"884",22,"Pakistan","1961",47060915,21697194,25363721,47060915,0
"885",22,"Pakistan","1962",48161841,22231652,25930189,48161841,0
"886",22,"Pakistan","1963",49325050,22798530,26526519,49325049,1
"887",22,"Pakistan","1964",50552592,23398883,27153709,50552592,0
"888",22,"Pakistan","1965",51841626,24030852,27810773,51841625,1
"889",22,"Pakistan","1966",53199414,24698014,28501400,53199414,0
"890",22,"Pakistan","1967",54629793,25401143,29228649,54629792,1
"891",22,"Pakistan","1968",56124743,26136537,29988206,56124743,0
"892",22,"Pakistan","1969",57676805,26900599,30776207,57676806,-1
"893",22,"Pakistan","1970",59290872,27696448,31594424,59290872,0
"894",22,"Pakistan","1971",60878781,28496527,32382253,60878780,1
"895",22,"Pakistan","1972",62509565,29317529,33192037,62509566,-1
"896",22,"Pakistan","1973",64285624,30194373,34091252,64285625,-1
"897",22,"Pakistan","1974",66149169,31115326,35033843,66149169,0
"898",22,"Pakistan","1975",68126999,32093585,36033414,68126999,0
"899",22,"Pakistan","1976",70230923,33135180,37095743,70230923,0
"900",22,"Pakistan","1977",72451105,34234632,38216474,72451106,-1
"901",22,"Pakistan","1978",74789330,35393003,39396326,74789329,1
"902",22,"Pakistan","1979",77407341,36695434,40711907,77407341,0
"903",22,"Pakistan","1980",80624057,38300711,42323346,80624057,0
"904",22,"Pakistan","1981",84270202,40120973,44149230,84270203,-1
"905",22,"Pakistan","1982",87828198,41898068,45930130,87828198,0
"906",22,"Pakistan","1983",91080372,43522925,47557446,91080371,1
"907",22,"Pakistan","1984",94003867,44983988,49019878,94003866,1
"908",22,"Pakistan","1985",97121552,46536484,50585068,97121552,0
"909",22,"Pakistan","1986",100618523,48269312,52349211,100618523,0
"910",22,"Pakistan","1987",104251093,50064842,54186251,104251093,0
"911",22,"Pakistan","1988",107967838,51899712,56068126,107967838,0
"912",22,"Pakistan","1989",111670386,53724935,57945452,111670387,-1
"913",22,"Pakistan","1990",115414069,55569854,59844215,115414069,0
"914",22,"Pakistan","1991",119203569,57435675,61767894,119203569,0
"915",22,"Pakistan","1992",122375179,58986038,63389141,122375179,0
"916",22,"Pakistan","1993",125546615,60526987,65019628,125546615,0
"917",22,"Pakistan","1994",129245139,62325262,66919877,129245139,0
"918",22,"Pakistan","1995",133117476,64211200,68906276,133117476,0
"919",22,"Pakistan","1996",137234810,66221856,71012953,137234809,1
"920",22,"Pakistan","1997",141330267,68225605,73104663,141330268,-1
"921",22,"Pakistan","1998",145476106,70258836,75217269,145476105,1
"922",22,"Pakistan","1999",149694462,72328261,77366201,149694462,0
"923",22,"Pakistan","2000",154369924,74623871,79746052,154369923,1
"924",22,"Pakistan","2001",159217727,77005059,82212668,159217727,0
"925",22,"Pakistan","2002",163262807,78984415,84278393,163262808,-1
"926",22,"Pakistan","2003",166876680,80749416,86127265,166876681,-1
"927",22,"Pakistan","2004",170648620,82599094,88049526,170648620,0
"928",22,"Pakistan","2005",174372098,84430090,89942008,174372098,0
"929",22,"Pakistan","2006",178069984,86259841,91810143,178069984,0
"930",22,"Pakistan","2007",181924521,88180519,93744001,181924520,1
"931",22,"Pakistan","2008",185931955,90186327,95745628,185931955,0
"932",22,"Pakistan","2009",190123222,92290019,97833204,190123223,-1
"933",22,"Pakistan","2010",194454498,94467014,99987484,194454498,0
"934",22,"Pakistan","2011",198602738,96555715,102047023,198602738,0
"935",22,"Pakistan","2012",202205861,98373877,103831984,202205861,0
"936",22,"Pakistan","2013",205337562,99958919,105378643,205337562,0
"937",22,"Pakistan","2014",208251628,101436628,106815000,208251628,0
"938",22,"Pakistan","2015",210969298,102985590,107983708,210969298,0
"939",22,"Pakistan","2016",213524840,104630327,108894512,213524839,1
"940",22,"Pakistan","2017",216379655,106376569,110003086,216379655,0
"941",22,"Pakistan","2018",219731479,108293156,111438323,219731479,0
"942",22,"Pakistan","2019",223293280,110278237,113015042,223293279,1
"943",22,"Pakistan","2020",227196741,112381099,114815641,227196740,1
"944",22,"Pakistan","2021",231402117,114586264,116815852,231402116,1
"945",22,"Pakistan","2022",235824862,116863982,118960880,235824862,0
"946",23,"Russia","1960",119897000,66181851,53715149,119897000,0
"947",23,"Russia","1961",121236000,66771372,54464628,121236000,0
"948",23,"Russia","1962",122591000,67377496,55213503,122590999,1
"949",23,"Russia","1963",123960000,67994913,55965087,123960000,0
"950",23,"Russia","1964",125345000,68632629,56712371,125345000,0
"951",23,"Russia","1965",126745000,69293561,57451440,126745001,-1
"952",23,"Russia","1966",127468000,69592893,57875108,127468001,-1
"953",23,"Russia","1967",128196000,69906130,58289869,128195999,1
"954",23,"Russia","1968",128928000,70223577,58704423,128928000,0
"955",23,"Russia","1969",129664000,70547384,59116615,129663999,1
"956",23,"Russia","1970",130404000,70983282,59420718,130404000,0
"957",23,"Russia","1971",131155000,71428810,59726190,131155000,0
"958",23,"Russia","1972",131909000,71772657,60136343,131909000,0
"959",23,"Russia","1973",132669000,72109234,60559766,132669000,0
"960",23,"Russia","1974",133432000,72446480,60985519,133431999,1
"961",23,"Russia","1975",134200000,72786254,61413746,134200000,0
"962",23,"Russia","1976",135147000,73214184,61932817,135147001,-1
"963",23,"Russia","1977",136100000,73628754,62471246,136100000,0
"964",23,"Russia","1978",137060000,74040649,63019351,137060000,0
"965",23,"Russia","1979",138027000,74479027,63547973,138027000,0
"966",23,"Russia","1980",139010000,74935230,64074770,139010000,0
"967",23,"Russia","1981",139941000,75351364,64589635,139940999,1
"968",23,"Russia","1982",140823000,75736169,65086831,140823000,0
"969",23,"Russia","1983",141668000,76096529,65571471,141668000,0
"970",23,"Russia","1984",142745000,76576316,66168683,142744999,1
"971",23,"Russia","1985",143858000,77067918,66790082,143858000,0
"972",23,"Russia","1986",144894000,77497245,67396755,144894000,0
"973",23,"Russia","1987",145908000,77892375,68015625,145908000,0
"974",23,"Russia","1988",146857000,78250507,68606492,146856999,1
"975",23,"Russia","1989",147721000,78585136,69135864,147721000,0
"976",23,"Russia","1990",147969407,78635282,69334125,147969407,0
"977",23,"Russia","1991",148394216,78819676,69574539,148394215,1
"978",23,"Russia","1992",148538197,78879774,69658422,148538196,1
"979",23,"Russia","1993",148458777,78843028,69615748,148458776,1
"980",23,"Russia","1994",148407912,78853448,69554464,148407912,0
"981",23,"Russia","1995",148375787,78902653,69473134,148375787,0
"982",23,"Russia","1996",148160129,78851889,69308240,148160129,0
"983",23,"Russia","1997",147915361,78760731,69154630,147915361,0
"984",23,"Russia","1998",147670784,78646825,69023959,147670784,0
"985",23,"Russia","1999",147214776,78420370,68794406,147214776,0
"986",23,"Russia","2000",146596869,78132050,68464819,146596869,0
"987",23,"Russia","2001",145976482,77868557,68107925,145976482,0
"988",23,"Russia","2002",145306497,77591468,67715029,145306497,0
"989",23,"Russia","2003",144648618,77339545,67309072,144648617,1
"990",23,"Russia","2004",144067316,77146216,66921101,144067317,-1
"991",23,"Russia","2005",143518814,76976788,66542026,143518814,0
"992",23,"Russia","2006",143049637,76829928,66219710,143049638,-1
"993",23,"Russia","2007",142805114,76754261,66050853,142805114,0
"994",23,"Russia","2008",142742366,76745227,65997139,142742366,0
"995",23,"Russia","2009",142785349,76775747,66009601,142785348,1
"996",23,"Russia","2010",142849468,76796366,66053102,142849468,0
"997",23,"Russia","2011",142960908,76823612,66137295,142960907,1
"998",23,"Russia","2012",143201721,76909131,66292589,143201720,1
"999",23,"Russia","2013",143506995,77025825,66481170,143506995,0
"1000",23,"Russia","2014",143819667,77153880,66665787,143819667,0
"1001",23,"Russia","2015",144096870,77273424,66823446,144096870,0
"1002",23,"Russia","2016",144342397,77378095,66964302,144342397,0
"1003",23,"Russia","2017",144496739,77431943,67064796,144496739,0
"1004",23,"Russia","2018",144477859,77393346,67084512,144477858,1
"1005",23,"Russia","2019",144406261,77329730,67076532,144406262,-1
"1006",23,"Russia","2020",144073139,77147284,66925854,144073138,1
"1007",23,"Russia","2021",143449286,76824577,66624709,143449286,0
"1008",23,"Russia","2022",143555736,76884903,66670833,143555736,0
"1009",24,"South Africa","1960",16520441,8017980,8502461,16520441,0
"1010",24,"South Africa","1961",16989464,8263745,8725719,16989464,0
"1011",24,"South Africa","1962",17503133,8532023,8971110,17503133,0
"1012",24,"South Africa","1963",18042215,8813888,9228327,18042215,0
"1013",24,"South Africa","1964",18603097,9107018,9496079,18603097,0
"1014",24,"South Africa","1965",19187194,9412255,9774939,19187194,0
"1015",24,"South Africa","1966",19789771,9726980,10062791,19789771,0
"1016",24,"South Africa","1967",20410677,10051232,10359445,20410677,0
"1017",24,"South Africa","1968",21050540,10385268,10665272,21050540,0
"1018",24,"South Africa","1969",21704214,10725797,10978417,21704214,0
"1019",24,"South Africa","1970",22368306,11070685,11297621,22368306,0
"1020",24,"South Africa","1971",23031441,11392269,11639172,23031441,0
"1021",24,"South Africa","1972",23698507,11690167,12008340,23698507,0
"1022",24,"South Africa","1973",24382513,11991274,12391239,24382513,0
"1023",24,"South Africa","1974",25077016,12297952,12779064,25077016,0
"1024",24,"South Africa","1975",25777964,12610329,13167635,25777964,0
"1025",24,"South Africa","1976",26480300,12931705,13548594,26480299,1
"1026",24,"South Africa","1977",27199838,13245666,13954172,27199838,0
"1027",24,"South Africa","1978",27943445,13549026,14394419,27943445,0
"1028",24,"South Africa","1979",28697014,13862168,14834845,28697013,1
"1029",24,"South Africa","1980",29463549,14186385,15277164,29463549,0
"1030",24,"South Africa","1981",30232561,14600980,15631582,30232562,-1
"1031",24,"South Africa","1982",31022417,15130329,15892088,31022417,0
"1032",24,"South Africa","1983",31865176,15739461,16125715,31865176,0
"1033",24,"South Africa","1984",32768207,16431317,16336890,32768207,0
"1034",24,"South Africa","1985",33752964,17243333,16509631,33752964,0
"1035",24,"South Africa","1986",34877834,17993069,16884765,34877834,0
"1036",24,"South Africa","1987",36119333,18604223,17515110,36119333,0
"1037",24,"South Africa","1988",37393853,19231343,18162510,37393853,0
"1038",24,"South Africa","1989",38668684,19858547,18810138,38668685,-1
"1039",24,"South Africa","1990",39877570,20454959,19422611,39877570,0
"1040",24,"South Africa","1991",40910959,20972094,19938864,40910958,1
"1041",24,"South Africa","1992",41760755,21471959,20288796,41760755,0
"1042",24,"South Africa","1993",42525440,22006067,20519374,42525441,-1
"1043",24,"South Africa","1994",43267982,22522796,20745186,43267982,0
"1044",24,"South Africa","1995",43986084,23025116,20960968,43986084,0
"1045",24,"South Africa","1996",44661603,23507455,21154148,44661603,0
"1046",24,"South Africa","1997",45285048,23879335,21405714,45285049,-1
"1047",24,"South Africa","1998",45852166,24148681,21703485,45852166,0
"1048",24,"South Africa","1999",46364681,24387653,21977029,46364682,-1
"1049",24,"South Africa","2000",46813266,24591889,22221377,46813266,0
"1050",24,"South Africa","2001",47229714,24781908,22447806,47229714,0
"1051",24,"South Africa","2002",47661514,24979734,22681781,47661515,-1
"1052",24,"South Africa","2003",48104048,25178665,22925383,48104048,0
"1053",24,"South Africa","2004",48556071,25379489,23176582,48556071,0
"1054",24,"South Africa","2005",49017147,25583854,23433293,49017147,0
"1055",24,"South Africa","2006",49491756,25795511,23696246,49491757,-1
"1056",24,"South Africa","2007",49996094,26023987,23972107,49996094,0
"1057",24,"South Africa","2008",50565812,26287724,24278088,50565812,0
"1058",24,"South Africa","2009",51170779,26570865,24599914,51170779,0
"1059",24,"South Africa","2010",51784921,26857414,24927507,51784921,0
"1060",24,"South Africa","2011",52443325,27164417,25278908,52443325,0
"1061",24,"South Africa","2012",53145033,27493643,25651390,53145033,0
"1062",24,"South Africa","2013",53873616,27837495,26036121,53873616,0
"1063",24,"South Africa","2014",54729551,28228865,26500685,54729550,1
"1064",24,"South Africa","2015",55876504,28721087,27155417,55876504,0
"1065",24,"South Africa","2016",56422274,29004108,27418165,56422273,1
"1066",24,"South Africa","2017",56641209,29175940,27465269,56641209,0
"1067",24,"South Africa","2018",57339635,29517286,27822349,57339635,0
"1068",24,"South Africa","2019",58087055,29879107,28207948,58087055,0
"1069",24,"South Africa","2020",58801927,30221143,28580784,58801927,0
"1070",24,"South Africa","2021",59392255,30497646,28894608,59392254,1
"1071",24,"South Africa","2022",59893885,30725879,29168006,59893885,0
"1072",25,"South America_Northern","1960",8997323,4459256,4538067,8997323,0
"1073",25,"South America_Northern","1961",9319672,4621066,4698606,9319672,0
"1074",25,"South America_Northern","1962",9647206,4785440,4861767,9647207,-1
"1075",25,"South America_Northern","1963",9979988,4952344,5027644,9979988,0
"1076",25,"South America_Northern","1964",10317578,5121654,5195924,10317578,0
"1077",25,"South America_Northern","1965",10659414,5293312,5366104,10659416,-2
"1078",25,"South America_Northern","1966",11006068,5467607,5538461,11006068,0
"1079",25,"South America_Northern","1967",11357532,5644269,5713265,11357534,-2
"1080",25,"South America_Northern","1968",11714009,5823358,5890652,11714010,-1
"1081",25,"South America_Northern","1969",12074872,6004584,6070288,12074872,0
"1082",25,"South America_Northern","1970",12440654,6188171,6252484,12440655,-1
"1083",25,"South America_Northern","1971",12811604,6374251,6437353,12811604,0
"1084",25,"South America_Northern","1972",13181144,6559893,6621251,13181144,0
"1085",25,"South America_Northern","1973",13551000,6746067,6804934,13551001,-1
"1086",25,"South America_Northern","1974",13928440,6935988,6992452,13928440,0
"1087",25,"South America_Northern","1975",14314114,7129945,7184167,14314112,2
"1088",25,"South America_Northern","1976",14708896,7328257,7380637,14708894,2
"1089",25,"South America_Northern","1977",15112438,7531014,7581426,15112440,-2
"1090",25,"South America_Northern","1978",15523453,7737729,7785722,15523451,2
"1091",25,"South America_Northern","1979",15940367,7947300,7993067,15940367,0
"1092",25,"South America_Northern","1980",16363731,8159959,8203773,16363732,-1
"1093",25,"South America_Northern","1981",16793971,8375918,8418053,16793971,0
"1094",25,"South America_Northern","1982",17228581,8593980,8634601,17228581,0
"1095",25,"South America_Northern","1983",17667377,8814069,8853308,17667377,0
"1096",25,"South America_Northern","1984",18111858,9036673,9075185,18111858,0
"1097",25,"South America_Northern","1985",18562146,9261870,9300276,18562146,0
"1098",25,"South America_Northern","1986",19021752,9491518,9530233,19021751,1
"1099",25,"South America_Northern","1987",19489228,9724960,9764266,19489226,2
"1100",25,"South America_Northern","1988",19961359,9960787,10000572,19961359,0
"1101",25,"South America_Northern","1989",20436549,10198318,10238230,20436548,1
"1102",25,"South America_Northern","1990",20910451,10434632,10475820,20910452,-1
"1103",25,"South America_Northern","1991",21386291,10671092,10715199,21386291,0
"1104",25,"South America_Northern","1992",21864980,10908576,10956403,21864979,1
"1105",25,"South America_Northern","1993",22341664,11145186,11196478,22341664,0
"1106",25,"South America_Northern","1994",22816927,11382035,11434892,22816927,0
"1107",25,"South America_Northern","1995",23293465,11619646,11673817,23293463,2
"1108",25,"South America_Northern","1996",23769515,11856455,11913062,23769517,-2
"1109",25,"South America_Northern","1997",24245659,12093336,12152320,24245656,3
"1110",25,"South America_Northern","1998",24722265,12331157,12391108,24722265,0
"1111",25,"South America_Northern","1999",25195432,12567905,12627527,25195432,0
"1112",25,"South America_Northern","2000",25665778,12804488,12861291,25665779,-1
"1113",25,"South America_Northern","2001",26127406,13038952,13088453,26127405,1
"1114",25,"South America_Northern","2002",26586918,13272478,13314439,26586917,1
"1115",25,"South America_Northern","2003",27046371,13506082,13540288,27046370,1
"1116",25,"South America_Northern","2004",27497923,13736906,13761017,27497923,0
"1117",25,"South America_Northern","2005",27944714,13965716,13978998,27944714,0
"1118",25,"South America_Northern","2006",28382471,14191156,14191314,28382470,1
"1119",25,"South America_Northern","2007",28809564,14412536,14397030,28809566,-2
"1120",25,"South America_Northern","2008",29221921,14628142,14593780,29221922,-1
"1121",25,"South America_Northern","2009",29619137,14836863,14782272,29619135,2
"1122",25,"South America_Northern","2010",30009034,15040870,14968165,30009035,-1
"1123",25,"South America_Northern","2011",30392535,15240928,15151606,30392534,1
"1124",25,"South America_Northern","2012",30772503,15439664,15332839,30772503,0
"1125",25,"South America_Northern","2013",31149388,15637326,15512063,31149389,-1
"1126",25,"South America_Northern","2014",31514055,15829092,15684963,31514055,0
"1127",25,"South America_Northern","2015",31860222,16012022,15848201,31860223,-1
"1128",25,"South America_Northern","2016",32082004,16134850,15947153,32082003,1
"1129",25,"South America_Northern","2017",31914244,16063658,15850588,31914246,-2
"1130",25,"South America_Northern","2018",31204882,15718365,15486516,31204881,1
"1131",25,"South America_Northern","2019",30370737,15312607,15058130,30370737,0
"1132",25,"South America_Northern","2020",29894720,15088406,14806315,29894721,-1
"1133",25,"South America_Northern","2021",29617419,14961586,14655833,29617419,0
"1134",25,"South America_Northern","2022",29728462,15028063,14700398,29728461,1
"1135",26,"South America_Southern","1960",31063550,15516826,15546726,31063552,-2
"1136",26,"South America_Southern","1961",31830243,15901154,15929090,31830244,-1
"1137",26,"South America_Southern","1962",32614596,16294471,16320125,32614596,0
"1138",26,"South America_Southern","1963",33411060,16694385,16716676,33411061,-1
"1139",26,"South America_Southern","1964",34223318,17102090,17121227,34223317,1
"1140",26,"South America_Southern","1965",35052959,17517681,17535276,35052957,2
"1141",26,"South America_Southern","1966",35892450,17937925,17954526,35892451,-1
"1142",26,"South America_Southern","1967",36742338,18363393,18378944,36742337,1
"1143",26,"South America_Southern","1968",37605967,18795503,18810461,37605964,3
"1144",26,"South America_Southern","1969",38482252,19233944,19248309,38482253,-1
"1145",26,"South America_Southern","1970",39339812,19661551,19678260,39339811,1
"1146",26,"South America_Southern","1971",40204826,20092891,20111934,40204825,1
"1147",26,"South America_Southern","1972",41108230,20546084,20562145,41108229,1
"1148",26,"South America_Southern","1973",42025303,21008325,21016978,42025303,0
"1149",26,"South America_Southern","1974",42956476,21478731,21477747,42956478,-2
"1150",26,"South America_Southern","1975",43901201,21956280,21944920,43901200,1
"1151",26,"South America_Southern","1976",44854104,22438264,22415839,44854103,1
"1152",26,"South America_Southern","1977",45826813,22928872,22897942,45826814,-1
"1153",26,"South America_Southern","1978",46825288,23431419,23393871,46825290,-2
"1154",26,"South America_Southern","1979",47836530,23940405,23896126,47836531,-1
"1155",26,"South America_Southern","1980",48866829,24457393,24409435,48866828,1
"1156",26,"South America_Southern","1981",49914924,24982159,24932767,49914926,-2
"1157",26,"South America_Southern","1982",50976365,25514913,25461454,50976367,-2
"1158",26,"South America_Southern","1983",52056473,26059065,25997409,52056474,-1
"1159",26,"South America_Southern","1984",53154456,26613914,26540545,53154459,-3
"1160",26,"South America_Southern","1985",54272663,27178508,27094156,54272664,-1
"1161",26,"South America_Southern","1986",55412250,27752367,27659885,55412252,-2
"1162",26,"South America_Southern","1987",56572791,28335828,28236964,56572792,-1
"1163",26,"South America_Southern","1988",57758245,28931473,28826771,57758244,1
"1164",26,"South America_Southern","1989",58961431,29536803,29424628,58961431,0
"1165",26,"South America_Southern","1990",60174205,30147271,30026936,60174207,-2
"1166",26,"South America_Southern","1991",61379491,30753581,30625911,61379492,-1
"1167",26,"South America_Southern","1992",62568969,31351516,31217454,62568970,-1
"1168",26,"South America_Southern","1993",63747535,31941242,31806293,63747535,0
"1169",26,"South America_Southern","1994",64920552,32524835,32395718,64920553,-1
"1170",26,"South America_Southern","1995",66081222,33102026,32979197,66081223,-1
"1171",26,"South America_Southern","1996",67225663,33672157,33553505,67225662,1
"1172",26,"South America_Southern","1997",68363490,34239784,34123709,68363493,-3
"1173",26,"South America_Southern","1998",69487721,34800946,34686777,69487723,-2
"1174",26,"South America_Southern","1999",70584741,35348658,35236085,70584743,-2
"1175",26,"South America_Southern","2000",71641444,35876244,35765200,71641444,0
"1176",26,"South America_Southern","2001",72642972,36377666,36265305,72642971,1
"1177",26,"South America_Southern","2002",73592438,36854196,36738243,73592439,-1
"1178",26,"South America_Southern","2003",74504471,37311268,37193206,74504474,-3
"1179",26,"South America_Southern","2004",75392874,37755800,37637073,75392873,1
"1180",26,"South America_Southern","2005",76264521,38190549,38073972,76264521,0
"1181",26,"South America_Southern","2006",77124334,38617664,38506671,77124335,-1
"1182",26,"South America_Southern","2007",77977708,39041105,38936601,77977706,2
"1183",26,"South America_Southern","2008",78826311,39480376,39345935,78826311,0
"1184",26,"South America_Southern","2009",79683586,39941168,39742420,79683588,-2
"1185",26,"South America_Southern","2010",80567853,40412720,40155135,80567855,-2
"1186",26,"South America_Southern","2011",81490844,40899194,40591650,81490844,0
"1187",26,"South America_Southern","2012",82439395,41394440,41044954,82439394,1
"1188",26,"South America_Southern","2013",83401904,41893753,41508150,83401903,1
"1189",26,"South America_Southern","2014",84398423,42405447,41992976,84398423,0
"1190",26,"South America_Southern","2015",85448742,42937964,42510779,85448743,-1
"1191",26,"South America_Southern","2016",86599639,43513553,43086087,86599640,-1
"1192",26,"South America_Southern","2017",87884144,44155486,43728661,87884147,-3
"1193",26,"South America_Southern","2018",89398341,44917184,44481159,89398343,-2
"1194",26,"South America_Southern","2019",90943836,45696508,45247329,90943837,-1
"1195",26,"South America_Southern","2020",92177609,46331647,45845963,92177610,-1
"1196",26,"South America_Southern","2021",93215923,46875654,46340271,93215925,-2
"1197",26,"South America_Southern","2022",94081969,47323883,46758087,94081970,-1
"1198",27,"South Asia","1960",79283623,38225789,41057833,79283622,1
"1199",27,"South Asia","1961",81381964,39264385,42117578,81381963,1
"1200",27,"South Asia","1962",83598240,40358795,43239445,83598240,0
"1201",27,"South Asia","1963",85890871,41486001,44404869,85890870,1
"1202",27,"South Asia","1964",88255569,42646107,45609461,88255568,1
"1203",27,"South Asia","1965",90693057,43840464,46852593,90693057,0
"1204",27,"South Asia","1966",93190015,45062778,48127238,93190016,-1
"1205",27,"South Asia","1967",95784991,46334740,49450251,95784991,0
"1206",27,"South Asia","1968",98456809,47644405,50812404,98456809,0
"1207",27,"South Asia","1969",101121343,48948972,52172372,101121344,-1
"1208",27,"South Asia","1970",103607022,50151836,53455188,103607024,-2
"1209",27,"South Asia","1971",105257485,51090378,54167106,105257484,1
"1210",27,"South Asia","1972",107050253,52107907,54942348,107050255,-2
"1211",27,"South Asia","1973",109690563,53391809,56298756,109690565,-2
"1212",27,"South Asia","1974",112342049,54680248,57661799,112342047,2
"1213",27,"South Asia","1975",114941540,55967447,58974094,114941541,-1
"1214",27,"South Asia","1976",117457842,57242585,60215255,117457840,2
"1215",27,"South Asia","1977",120062750,58557805,61504945,120062750,0
"1216",27,"South Asia","1978",122795095,59930122,62864971,122795093,2
"1217",27,"South Asia","1979",125375860,61230551,64145309,125375860,0
"1218",27,"South Asia","1980",127540627,62322492,65218135,127540627,0
"1219",27,"South Asia","1981",129077045,63093188,65983857,129077045,0
"1220",27,"South Asia","1982",131046226,64065743,66980481,131046224,2
"1221",27,"South Asia","1983",134031405,65532210,68499197,134031407,-2
"1222",27,"South Asia","1984",137446665,67218691,70227974,137446665,0
"1223",27,"South Asia","1985",140779140,68879677,71899464,140779141,-1
"1224",27,"South Asia","1986",143671485,70323136,73348346,143671482,3
"1225",27,"South Asia","1987",146404639,71686319,74718320,146404639,0
"1226",27,"South Asia","1988",149306985,73134054,76172929,149306983,2
"1227",27,"South Asia","1989",152464640,74698390,77766251,152464641,-1
"1228",27,"South Asia","1990",155446470,76159264,79287207,155446471,-1
"1229",27,"South Asia","1991",158335236,77574191,80761045,158335236,0
"1230",27,"South Asia","1992",162441205,79616675,82824531,162441206,-1
"1231",27,"South Asia","1993",167282170,82035725,85246449,167282174,-4
"1232",27,"South Asia","1994",171650402,84218702,87431698,171650400,2
"1233",27,"South Asia","1995",175481137,86147010,89334127,175481137,0
"1234",27,"South Asia","1996",178891273,87873804,91017473,178891277,-4
"1235",27,"South Asia","1997",182342490,89627539,92714951,182342490,0
"1236",27,"South Asia","1998",185938668,91466345,94472321,185938666,2
"1237",27,"South Asia","1999",189680340,93374788,96305552,189680340,0
"1238",27,"South Asia","2000",192941894,95047362,97894535,192941897,-3
"1239",27,"South Asia","2001",196126020,96706460,99419561,196126021,-1
"1240",27,"South Asia","2002",200494299,98989570,101504728,200494298,1
"1241",27,"South Asia","2003",205066277,101404697,103661582,205066279,-2
"1242",27,"South Asia","2004",208789798,103413090,105376707,208789797,1
"1243",27,"South Asia","2005",212253098,105314138,106938959,212253097,1
"1244",27,"South Asia","2006",215449113,107138756,108310358,215449114,-1
"1245",27,"South Asia","2007",217838285,108583195,109255091,217838286,-1
"1246",27,"South Asia","2008",220042324,109960341,110081981,220042322,2
"1247",27,"South Asia","2009",222648250,111526055,111122195,222648250,0
"1248",27,"South Asia","2010",225478026,113129482,112348544,225478026,0
"1249",27,"South Asia","2011",228674075,114888467,113785607,228674074,1
"1250",27,"South Asia","2012",232013653,116709140,115304514,232013654,-1
"1251",27,"South Asia","2013",235214276,118461671,116752604,235214275,1
"1252",27,"South Asia","2014",238532167,120264549,118267617,238532166,1
"1253",27,"South Asia","2015",241709377,121974692,119734686,241709378,-1
"1254",27,"South Asia","2016",244911468,123657712,121253760,244911472,-4
"1255",27,"South Asia","2017",248356184,125439589,122916595,248356184,0
"1256",27,"South Asia","2018",251799308,127236091,124563217,251799308,0
"1257",27,"South Asia","2019",255193184,129020853,126172331,255193184,0
"1258",27,"South Asia","2020",258947752,130940292,128007462,258947754,-2
"1259",27,"South Asia","2021",262945645,132934906,130010740,262945646,-1
"1260",27,"South Asia","2022",266349965,134680052,131669912,266349964,1
"1261",28,"South Korea","1960",25012374,12489338,12523036,25012374,0
"1262",28,"South Korea","1961",25765673,12855534,12910139,25765673,0
"1263",28,"South Korea","1962",26513030,13210403,13302628,26513031,-1
"1264",28,"South Korea","1963",27261747,13563924,13697823,27261747,0
"1265",28,"South Korea","1964",27984155,13904602,14079553,27984155,0
"1266",28,"South Korea","1965",28704674,14247148,14457525,28704673,1
"1267",28,"South Korea","1966",29435571,14605847,14829724,29435571,0
"1268",28,"South Korea","1967",30130983,14956378,15174605,30130983,0
"1269",28,"South Korea","1968",30838302,15313681,15524621,30838302,0
"1270",28,"South Korea","1969",31544266,15670972,15873294,31544266,0
"1271",28,"South Korea","1970",32240827,16023621,16217206,32240827,0
"1272",28,"South Korea","1971",32882704,16345322,16537381,32882703,1
"1273",28,"South Korea","1972",33505406,16652912,16852495,33505407,-1
"1274",28,"South Korea","1973",34103149,16947289,17155860,34103149,0
"1275",28,"South Korea","1974",34692266,17235516,17456750,34692266,0
"1276",28,"South Korea","1975",35280725,17526507,17754217,35280724,1
"1277",28,"South Korea","1976",35848523,17817685,18030838,35848523,0
"1278",28,"South Korea","1977",36411795,18112175,18299620,36411795,0
"1279",28,"South Korea","1978",36969185,18404430,18564755,36969185,0
"1280",28,"South Korea","1979",37534236,18701467,18832769,37534236,0
"1281",28,"South Korea","1980",38123775,19011317,19112458,38123775,0
"1282",28,"South Korea","1981",38723248,19322543,19400705,38723248,0
"1283",28,"South Korea","1982",39326352,19631317,19695035,39326352,0
"1284",28,"South Korea","1983",39910403,19929832,19980571,39910403,0
"1285",28,"South Korea","1984",40405956,20182770,20223186,40405956,0
"1286",28,"South Korea","1985",40805744,20385468,20420276,40805744,0
"1287",28,"South Korea","1986",41213674,20582576,20631098,41213674,0
"1288",28,"South Korea","1987",41621690,20772477,20849213,41621690,0
"1289",28,"South Korea","1988",42031247,20962445,21068803,42031248,-1
"1290",28,"South Korea","1989",42449038,21154831,21294208,42449039,-1
"1291",28,"South Korea","1990",42869283,21346470,21522813,42869283,0
"1292",28,"South Korea","1991",43295704,21548966,21746739,43295705,-1
"1293",28,"South Korea","1992",43747962,21773212,21974750,43747962,0
"1294",28,"South Korea","1993",44194628,21992707,22201921,44194628,0
"1295",28,"South Korea","1994",44641540,22210858,22430682,44641540,0
"1296",28,"South Korea","1995",45092991,22432247,22660743,45092990,1
"1297",28,"South Korea","1996",45524681,22645433,22879247,45524680,1
"1298",28,"South Korea","1997",45953580,22859276,23094304,45953580,0
"1299",28,"South Korea","1998",46286503,23026003,23260500,46286503,0
"1300",28,"South Korea","1999",46616677,23190296,23426381,46616677,0
"1301",28,"South Korea","2000",47008111,23385302,23622809,47008111,0
"1302",28,"South Korea","2001",47370164,23577705,23792460,47370165,-1
"1303",28,"South Korea","2002",47644736,23737995,23906741,47644736,0
"1304",28,"South Korea","2003",47892330,23885395,24006936,47892331,-1
"1305",28,"South Korea","2004",48082519,24005609,24076910,48082519,0
"1306",28,"South Korea","2005",48184561,24081655,24102905,48184560,1
"1307",28,"South Korea","2006",48438292,24228799,24209494,48438293,-1
"1308",28,"South Korea","2007",48683638,24368149,24315489,48683638,0
"1309",28,"South Korea","2008",49054708,24570971,24483738,49054709,-1
"1310",28,"South Korea","2009",49307835,24715248,24592587,49307835,0
"1311",28,"South Korea","2010",49554112,24852253,24701859,49554112,0
"1312",28,"South Korea","2011",49936638,25034107,24902531,49936638,0
"1313",28,"South Korea","2012",50199853,25137200,25062652,50199852,1
"1314",28,"South Korea","2013",50428893,25224087,25204806,50428893,0
"1315",28,"South Korea","2014",50746659,25356139,25390519,50746658,1
"1316",28,"South Korea","2015",51014947,25466609,25548338,51014947,0
"1317",28,"South Korea","2016",51217803,25566204,25651599,51217803,0
"1318",28,"South Korea","2017",51361911,25654936,25706975,51361911,0
"1319",28,"South Korea","2018",51585058,25783018,25802041,51585059,-1
"1320",28,"South Korea","2019",51764822,25889856,25874966,51764822,0
"1321",28,"South Korea","2020",51836239,25938911,25897329,51836240,-1
"1322",28,"South Korea","2021",51744876,25902500,25842376,51744876,0
"1323",28,"South Korea","2022",51628117,25854364,25773753,51628117,0
"1324",29,"Southeast Asia","1960",142074503,71521456,70553051,142074507,-4
"1325",29,"Southeast Asia","1961",145945003,73457644,72487363,145945007,-4
"1326",29,"Southeast Asia","1962",149869704,75426243,74443461,149869704,0
"1327",29,"Southeast Asia","1963",153970462,77483009,76487453,153970462,0
"1328",29,"Southeast Asia","1964",158144446,79577572,78566873,158144445,1
"1329",29,"Southeast Asia","1965",162367627,81698295,80669335,162367630,-3
"1330",29,"Southeast Asia","1966",166621118,83835750,82785365,166621115,3
"1331",29,"Southeast Asia","1967",170917706,85995456,84922252,170917708,-2
"1332",29,"Southeast Asia","1968",175238328,88176247,87062080,175238327,1
"1333",29,"Southeast Asia","1969",179592591,90379816,89212775,179592591,0
"1334",29,"Southeast Asia","1970",183968388,92577523,91390861,183968384,4
"1335",29,"Southeast Asia","1971",188429861,94787446,93642419,188429865,-4
"1336",29,"Southeast Asia","1972",193002975,97043851,95959126,193002977,-2
"1337",29,"Southeast Asia","1973",197564299,99297660,98266644,197564304,-5
"1338",29,"Southeast Asia","1974",202027659,101502918,100524748,202027666,-7
"1339",29,"Southeast Asia","1975",206296860,103668765,102628093,206296858,2
"1340",29,"Southeast Asia","1976",210480415,105828946,104651471,210480417,-2
"1341",29,"Southeast Asia","1977",214970283,108111397,106858880,214970277,6
"1342",29,"Southeast Asia","1978",219774186,110542957,109231229,219774186,0
"1343",29,"Southeast Asia","1979",224627375,113045049,111582321,224627370,5
"1344",29,"Southeast Asia","1980",229608487,115598447,114010040,229608487,0
"1345",29,"Southeast Asia","1981",234908347,118251429,116656919,234908348,-1
"1346",29,"Southeast Asia","1982",240327712,120958509,119369205,240327714,-2
"1347",29,"Southeast Asia","1983",245799509,123691974,122107530,245799504,5
"1348",29,"Southeast Asia","1984",251394976,126485400,124909573,251394973,3
"1349",29,"Southeast Asia","1985",256967896,129266293,127701605,256967898,-2
"1350",29,"Southeast Asia","1986",262585872,132069378,130516496,262585874,-2
"1351",29,"Southeast Asia","1987",268280470,134908146,133372328,268280474,-4
"1352",29,"Southeast Asia","1988",274009081,137764758,136244317,274009075,6
"1353",29,"Southeast Asia","1989",279795016,140646202,139148811,279795013,3
"1354",29,"Southeast Asia","1990",285735261,143616806,142118462,285735268,-7
"1355",29,"Southeast Asia","1991",291676586,146598274,145078310,291676584,2
"1356",29,"Southeast Asia","1992",297717969,149613396,148104578,297717974,-5
"1357",29,"Southeast Asia","1993",303833003,152668012,151164991,303833003,0
"1358",29,"Southeast Asia","1994",309816049,155681316,154134734,309816050,-1
"1359",29,"Southeast Asia","1995",315588575,158596353,156992214,315588567,8
"1360",29,"Southeast Asia","1996",321336240,161494263,159841978,321336241,-1
"1361",29,"Southeast Asia","1997",327044566,164377824,162666743,327044567,-1
"1362",29,"Southeast Asia","1998",332658138,167216419,165441718,332658137,1
"1363",29,"Southeast Asia","1999",337978096,169912863,168065233,337978096,0
"1364",29,"Southeast Asia","2000",343054389,172445782,170608604,343054386,3
"1365",29,"Southeast Asia","2001",348008864,174869119,173139745,348008864,0
"1366",29,"Southeast Asia","2002",352859235,177236245,175622988,352859233,2
"1367",29,"Southeast Asia","2003",357590697,179548449,178042247,357590696,1
"1368",29,"Southeast Asia","2004",362419360,181910362,180508998,362419360,0
"1369",29,"Southeast Asia","2005",367223536,184250864,182972674,367223538,-2
"1370",29,"Southeast Asia","2006",371990297,186558888,185431409,371990297,0
"1371",29,"Southeast Asia","2007",376821806,188902261,187919542,376821803,3
"1372",29,"Southeast Asia","2008",381667830,191267083,190400747,381667830,0
"1373",29,"Southeast Asia","2009",386414743,193608387,192806355,386414742,1
"1374",29,"Southeast Asia","2010",391143395,195965431,195177966,391143397,-2
"1375",29,"Southeast Asia","2011",395884158,198326507,197557644,395884151,7
"1376",29,"Southeast Asia","2012",400694955,200714562,199980390,400694952,3
"1377",29,"Southeast Asia","2013",405442769,203071133,202371635,405442768,1
"1378",29,"Southeast Asia","2014",410090514,205380064,204710443,410090507,7
"1379",29,"Southeast Asia","2015",414734277,207685998,207048277,414734275,2
"1380",29,"Southeast Asia","2016",419476344,210043283,209433065,419476348,-4
"1381",29,"Southeast Asia","2017",424094549,212346577,211747971,424094548,1
"1382",29,"Southeast Asia","2018",428551838,214574147,213977694,428551841,-3
"1383",29,"Southeast Asia","2019",432919751,216761763,216157988,432919751,0
"1384",29,"Southeast Asia","2020",437204078,218910111,218293972,437204083,-5
"1385",29,"Southeast Asia","2021",441021898,220841542,220180356,441021898,0
"1386",29,"Southeast Asia","2022",445084830,222887191,222197640,445084831,-1
"1387",3,"Africa_Northern","1960",55821033,27719299,28101733,55821032,1
"1388",3,"Africa_Northern","1961",57143334,28368324,28775009,57143333,1
"1389",3,"Africa_Northern","1962",58484940,29016116,29468826,58484942,-2
"1390",3,"Africa_Northern","1963",59869757,29682150,30187606,59869756,1
"1391",3,"Africa_Northern","1964",61291520,30361371,30930151,61291522,-2
"1392",3,"Africa_Northern","1965",62738959,31050000,31688959,62738959,0
"1393",3,"Africa_Northern","1966",64253826,31786965,32466860,64253825,1
"1394",3,"Africa_Northern","1967",65855133,32582613,33272520,65855133,0
"1395",3,"Africa_Northern","1968",67490077,33394559,34095517,67490076,1
"1396",3,"Africa_Northern","1969",69141938,34215923,34926014,69141937,1
"1397",3,"Africa_Northern","1970",70808833,35047148,35761683,70808831,2
"1398",3,"Africa_Northern","1971",72483900,35885885,36598014,72483899,1
"1399",3,"Africa_Northern","1972",74184898,36744057,37440841,74184898,0
"1400",3,"Africa_Northern","1973",75944603,37638752,38305851,75944603,0
"1401",3,"Africa_Northern","1974",77778921,38568627,39210294,77778921,0
"1402",3,"Africa_Northern","1975",79886516,39628665,40257851,79886516,0
"1403",3,"Africa_Northern","1976",82249840,40813974,41435865,82249839,1
"1404",3,"Africa_Northern","1977",84552594,41960693,42591902,84552595,-1
"1405",3,"Africa_Northern","1978",86820133,43082645,43737488,86820133,0
"1406",3,"Africa_Northern","1979",89200208,44258626,44941583,89200209,-1
"1407",3,"Africa_Northern","1980",91707254,45492358,46214895,91707253,1
"1408",3,"Africa_Northern","1981",94315255,46772464,47542791,94315255,0
"1409",3,"Africa_Northern","1982",97015928,48098199,48917731,97015930,-2
"1410",3,"Africa_Northern","1983",99838019,49479161,50358860,99838021,-2
"1411",3,"Africa_Northern","1984",102730948,50895931,51835018,102730949,-1
"1412",3,"Africa_Northern","1985",105664230,52338408,53325822,105664230,0
"1413",3,"Africa_Northern","1986",108606921,53788442,54818476,108606918,3
"1414",3,"Africa_Northern","1987",111493596,55211234,56282361,111493595,1
"1415",3,"Africa_Northern","1988",114352407,56615949,57736459,114352408,-1
"1416",3,"Africa_Northern","1989",117189892,58006471,59183422,117189893,-1
"1417",3,"Africa_Northern","1990",119980524,59372965,60607558,119980523,1
"1418",3,"Africa_Northern","1991",122697844,60708881,61988964,122697845,-1
"1419",3,"Africa_Northern","1992",125385481,62033052,63352430,125385482,-1
"1420",3,"Africa_Northern","1993",128065447,63350723,64714727,128065450,-3
"1421",3,"Africa_Northern","1994",130698841,64645512,66053329,130698841,0
"1422",3,"Africa_Northern","1995",133271143,65912276,67358866,133271142,1
"1423",3,"Africa_Northern","1996",135799538,67135406,68664132,135799538,0
"1424",3,"Africa_Northern","1997",138327171,68333174,69993997,138327171,0
"1425",3,"Africa_Northern","1998",140820614,69534822,71285794,140820616,-2
"1426",3,"Africa_Northern","1999",143277032,70739696,72537334,143277030,2
"1427",3,"Africa_Northern","2000",145748513,71960530,73787984,145748514,-1
"1428",3,"Africa_Northern","2001",148256382,73209015,75047366,148256381,1
"1429",3,"Africa_Northern","2002",150820159,74482056,76338102,150820158,1
"1430",3,"Africa_Northern","2003",153416914,75771788,77645127,153416915,-1
"1431",3,"Africa_Northern","2004",156045526,77086565,78958958,156045523,3
"1432",3,"Africa_Northern","2005",158690232,78413659,80276573,158690232,0
"1433",3,"Africa_Northern","2006",161354699,79740868,81613833,161354701,-2
"1434",3,"Africa_Northern","2007",164112787,81105335,83007454,164112789,-2
"1435",3,"Africa_Northern","2008",166958117,82512825,84445292,166958117,0
"1436",3,"Africa_Northern","2009",169884673,83961395,85923279,169884674,-1
"1437",3,"Africa_Northern","2010",172960673,85482441,87478231,172960672,1
"1438",3,"Africa_Northern","2011",175867954,86904051,88963901,175867952,2
"1439",3,"Africa_Northern","2012",178897361,88388716,90508646,178897362,-1
"1440",3,"Africa_Northern","2013",182467548,90158885,92308666,182467551,-3
"1441",3,"Africa_Northern","2014",186127807,91975658,94152148,186127806,1
"1442",3,"Africa_Northern","2015",189697425,93746393,95951032,189697425,0
"1443",3,"Africa_Northern","2016",193198486,95484116,97714369,193198485,1
"1444",3,"Africa_Northern","2017",196643751,97197138,99446614,196643752,-1
"1445",3,"Africa_Northern","2018",200006117,98871408,101134710,200006118,-1
"1446",3,"Africa_Northern","2019",203246849,100487020,102759829,203246849,0
"1447",3,"Africa_Northern","2020",206421237,102073193,104348043,206421236,1
"1448",3,"Africa_Northern","2021",209514954,103625208,105889746,209514954,0
"1449",3,"Africa_Northern","2022",212519757,105135126,107384631,212519757,0
"1450",30,"Taiwan","1960",0,0,0,0,0
"1451",30,"Taiwan","1961",0,0,0,0,0
"1452",30,"Taiwan","1962",0,0,0,0,0
"1453",30,"Taiwan","1963",0,0,0,0,0
"1454",30,"Taiwan","1964",0,0,0,0,0
"1455",30,"Taiwan","1965",0,0,0,0,0
"1456",30,"Taiwan","1966",0,0,0,0,0
"1457",30,"Taiwan","1967",0,0,0,0,0
"1458",30,"Taiwan","1968",0,0,0,0,0
"1459",30,"Taiwan","1969",0,0,0,0,0
"1460",30,"Taiwan","1970",0,0,0,0,0
"1461",30,"Taiwan","1971",0,0,0,0,0
"1462",30,"Taiwan","1972",0,0,0,0,0
"1463",30,"Taiwan","1973",0,0,0,0,0
"1464",30,"Taiwan","1974",0,0,0,0,0
"1465",30,"Taiwan","1975",0,0,0,0,0
"1466",30,"Taiwan","1976",0,0,0,0,0
"1467",30,"Taiwan","1977",0,0,0,0,0
"1468",30,"Taiwan","1978",0,0,0,0,0
"1469",30,"Taiwan","1979",0,0,0,0,0
"1470",30,"Taiwan","1980",0,0,0,0,0
"1471",30,"Taiwan","1981",0,0,0,0,0
"1472",30,"Taiwan","1982",0,0,0,0,0
"1473",30,"Taiwan","1983",0,0,0,0,0
"1474",30,"Taiwan","1984",0,0,0,0,0
"1475",30,"Taiwan","1985",0,0,0,0,0
"1476",30,"Taiwan","1986",0,0,0,0,0
"1477",30,"Taiwan","1987",0,0,0,0,0
"1478",30,"Taiwan","1988",0,0,0,0,0
"1479",30,"Taiwan","1989",0,0,0,0,0
"1480",30,"Taiwan","1990",0,0,0,0,0
"1481",30,"Taiwan","1991",0,0,0,0,0
"1482",30,"Taiwan","1992",0,0,0,0,0
"1483",30,"Taiwan","1993",0,0,0,0,0
"1484",30,"Taiwan","1994",0,0,0,0,0
"1485",30,"Taiwan","1995",0,0,0,0,0
"1486",30,"Taiwan","1996",0,0,0,0,0
"1487",30,"Taiwan","1997",0,0,0,0,0
"1488",30,"Taiwan","1998",0,0,0,0,0
"1489",30,"Taiwan","1999",0,0,0,0,0
"1490",30,"Taiwan","2000",0,0,0,0,0
"1491",30,"Taiwan","2001",0,0,0,0,0
"1492",30,"Taiwan","2002",0,0,0,0,0
"1493",30,"Taiwan","2003",0,0,0,0,0
"1494",30,"Taiwan","2004",0,0,0,0,0
"1495",30,"Taiwan","2005",0,0,0,0,0
"1496",30,"Taiwan","2006",0,0,0,0,0
"1497",30,"Taiwan","2007",0,0,0,0,0
"1498",30,"Taiwan","2008",0,0,0,0,0
"1499",30,"Taiwan","2009",0,0,0,0,0
"1500",30,"Taiwan","2010",0,0,0,0,0
"1501",30,"Taiwan","2011",0,0,0,0,0
"1502",30,"Taiwan","2012",0,0,0,0,0
"1503",30,"Taiwan","2013",0,0,0,0,0
"1504",30,"Taiwan","2014",0,0,0,0,0
"1505",30,"Taiwan","2015",0,0,0,0,0
"1506",30,"Taiwan","2016",0,0,0,0,0
"1507",30,"Taiwan","2017",0,0,0,0,0
"1508",30,"Taiwan","2018",0,0,0,0,0
"1509",30,"Taiwan","2019",0,0,0,0,0
"1510",30,"Taiwan","2020",0,0,0,0,0
"1511",30,"Taiwan","2021",0,0,0,0,0
"1512",30,"Taiwan","2022",0,0,0,0,0
"1513",31,"Argentina","1960",20349744,10158262,10191482,20349744,0
"1514",31,"Argentina","1961",20680653,10335069,10345584,20680653,0
"1515",31,"Argentina","1962",21020359,10513699,10506660,21020359,0
"1516",31,"Argentina","1963",21364017,10694826,10669192,21364018,-1
"1517",31,"Argentina","1964",21708487,10876693,10831793,21708486,1
"1518",31,"Argentina","1965",22053661,11058981,10994680,22053661,0
"1519",31,"Argentina","1966",22403116,11243003,11160113,22403116,0
"1520",31,"Argentina","1967",22757014,11429390,11327623,22757013,1
"1521",31,"Argentina","1968",23112971,11617792,11495179,23112971,0
"1522",31,"Argentina","1969",23472028,11808657,11663371,23472028,0
"1523",31,"Argentina","1970",23842803,12005045,11837757,23842802,1
"1524",31,"Argentina","1971",24223379,12208669,12014710,24223379,0
"1525",31,"Argentina","1972",24612794,12419477,12193317,24612794,0
"1526",31,"Argentina","1973",25020588,12639130,12381457,25020587,1
"1527",31,"Argentina","1974",25449754,12869638,12580117,25449755,-1
"1528",31,"Argentina","1975",25875558,13096382,12779176,25875558,0
"1529",31,"Argentina","1976",26290257,13315154,12975103,26290257,0
"1530",31,"Argentina","1977",26713780,13538001,13175780,26713781,-1
"1531",31,"Argentina","1978",27146121,13764006,13382114,27146120,1
"1532",31,"Argentina","1979",27584134,13991784,13592350,27584134,0
"1533",31,"Argentina","1980",28024803,14220750,13804052,28024802,1
"1534",31,"Argentina","1981",28471285,14453114,14018171,28471285,0
"1535",31,"Argentina","1982",28922762,14688513,14234248,28922761,1
"1536",31,"Argentina","1983",29377137,14924486,14452651,29377137,0
"1537",31,"Argentina","1984",29832197,15159735,14672462,29832197,0
"1538",31,"Argentina","1985",30287112,15392805,14894307,30287112,0
"1539",31,"Argentina","1986",30748326,15626548,15121779,30748327,-1
"1540",31,"Argentina","1987",31216453,15862727,15353727,31216454,-1
"1541",31,"Argentina","1988",31690792,16100939,15589854,31690793,-1
"1542",31,"Argentina","1989",32165766,16338719,15827047,32165766,0
"1543",31,"Argentina","1990",32637657,16574141,16063515,32637656,1
"1544",31,"Argentina","1991",33105763,16807594,16298168,33105762,1
"1545",31,"Argentina","1992",33568285,17039077,16529209,33568286,-1
"1546",31,"Argentina","1993",34027240,17269492,16757748,34027240,0
"1547",31,"Argentina","1994",34488696,17499129,16989567,34488696,0
"1548",31,"Argentina","1995",34946110,17725502,17220607,34946109,1
"1549",31,"Argentina","1996",35389362,17946204,17443158,35389362,0
"1550",31,"Argentina","1997",35815971,18160104,17655867,35815971,0
"1551",31,"Argentina","1998",36233195,18370060,17863135,36233195,0
"1552",31,"Argentina","1999",36653031,18580528,18072503,36653031,0
"1553",31,"Argentina","2000",37070774,18790028,18280746,37070774,0
"1554",31,"Argentina","2001",37480493,18996369,18484124,37480493,0
"1555",31,"Argentina","2002",37885028,19201347,18683681,37885028,0
"1556",31,"Argentina","2003",38278164,19398462,18879701,38278163,1
"1557",31,"Argentina","2004",38668796,19591796,19077001,38668797,-1
"1558",31,"Argentina","2005",39070501,19791355,19279145,39070500,1
"1559",31,"Argentina","2006",39476851,19992747,19484104,39476851,0
"1560",31,"Argentina","2007",39876111,20190731,19685381,39876112,-1
"1561",31,"Argentina","2008",40273769,20387718,19886051,40273769,0
"1562",31,"Argentina","2009",40684338,20588982,20095357,40684339,-1
"1563",31,"Argentina","2010",40788453,20633966,20154486,40788452,1
"1564",31,"Argentina","2011",41261490,20865767,20395723,41261490,0
"1565",31,"Argentina","2012",41733271,21099001,20634269,41733270,1
"1566",31,"Argentina","2013",42202935,21332490,20870445,42202935,0
"1567",31,"Argentina","2014",42669500,21562981,21106519,42669500,0
"1568",31,"Argentina","2015",43131966,21791541,21340426,43131967,-1
"1569",31,"Argentina","2016",43590368,22019065,21571303,43590368,0
"1570",31,"Argentina","2017",44044811,22244116,21800696,44044812,-1
"1571",31,"Argentina","2018",44494502,22467488,22027014,44494502,0
"1572",31,"Argentina","2019",44938712,22689693,22249019,44938712,0
"1573",31,"Argentina","2020",45376763,22911069,22465694,45376763,0
"1574",31,"Argentina","2021",45808747,23130548,22678199,45808747,0
"1575",31,"Argentina","2022",46234830,23345532,22889298,46234830,0
"1576",32,"Colombia","1960",15687688,7875810,7811878,15687688,0
"1577",32,"Colombia","1961",16182414,8121112,8061302,16182414,0
"1578",32,"Colombia","1962",16691282,8373228,8318055,16691283,-1
"1579",32,"Colombia","1963",17210956,8630444,8580512,17210956,0
"1580",32,"Colombia","1964",17739754,8891960,8847794,17739754,0
"1581",32,"Colombia","1965",18275814,9156915,9118899,18275814,0
"1582",32,"Colombia","1966",18811407,9421433,9389974,18811407,0
"1583",32,"Colombia","1967",19343961,9684298,9659663,19343961,0
"1584",32,"Colombia","1968",19872503,9945164,9927339,19872503,0
"1585",32,"Colombia","1969",20392264,10201733,10190531,20392264,0
"1586",32,"Colombia","1970",20905254,10455025,10450228,20905253,1
"1587",32,"Colombia","1971",21405413,10701994,10703420,21405414,-1
"1588",32,"Colombia","1972",21898055,10945364,10952691,21898055,0
"1589",32,"Colombia","1973",22396318,11191768,11204549,22396317,1
"1590",32,"Colombia","1974",22897871,11439917,11457953,22897870,1
"1591",32,"Colombia","1975",23403731,11690305,11713426,23403731,0
"1592",32,"Colombia","1976",23913002,11942621,11970381,23913002,0
"1593",32,"Colombia","1977",24443926,12206091,12237835,24443926,0
"1594",32,"Colombia","1978",25003608,12484354,12519254,25003608,0
"1595",32,"Colombia","1979",25579323,12771020,12808303,25579323,0
"1596",32,"Colombia","1980",26176195,13068691,13107504,26176195,0
"1597",32,"Colombia","1981",26785982,13373253,13412729,26785982,0
"1598",32,"Colombia","1982",27405194,13682869,13722325,27405194,0
"1599",32,"Colombia","1983",28042329,14001947,14040382,28042329,0
"1600",32,"Colombia","1984",28689032,14326594,14362438,28689032,0
"1601",32,"Colombia","1985",29326260,14646986,14679273,29326259,1
"1602",32,"Colombia","1986",29960101,14966988,14993112,29960100,1
"1603",32,"Colombia","1987",30603048,15293772,15309275,30603047,1
"1604",32,"Colombia","1988",31256727,15627949,15628778,31256727,0
"1605",32,"Colombia","1989",31923117,15970252,15952865,31923117,0
"1606",32,"Colombia","1990",32601393,16319819,16281573,32601392,1
"1607",32,"Colombia","1991",33272628,16666875,16605752,33272627,1
"1608",32,"Colombia","1992",33939039,17012155,16926884,33939039,0
"1609",32,"Colombia","1993",34614735,17362186,17252549,34614735,0
"1610",32,"Colombia","1994",35295461,17714470,17580991,35295461,0
"1611",32,"Colombia","1995",35970101,18063500,17906602,35970102,-1
"1612",32,"Colombia","1996",36632573,18406405,18226168,36632573,0
"1613",32,"Colombia","1997",37291946,18747884,18544061,37291945,1
"1614",32,"Colombia","1998",37944414,19086068,18858347,37944415,-1
"1615",32,"Colombia","1999",38585033,19418369,19166664,38585033,0
"1616",32,"Colombia","2000",39215135,19745251,19469885,39215136,-1
"1617",32,"Colombia","2001",39837875,20068231,19769644,39837875,0
"1618",32,"Colombia","2002",40454050,20387506,20066543,40454049,1
"1619",32,"Colombia","2003",41057687,20699708,20357979,41057687,0
"1620",32,"Colombia","2004",41648268,21004780,20643488,41648268,0
"1621",32,"Colombia","2005",42220940,21300552,20920388,42220940,0
"1622",32,"Colombia","2006",42772910,21586300,21186610,42772910,0
"1623",32,"Colombia","2007",43306582,21863668,21442913,43306581,1
"1624",32,"Colombia","2008",43815313,22128690,21686623,43815313,0
"1625",32,"Colombia","2009",44313917,22387951,21925966,44313917,0
"1626",32,"Colombia","2010",44816108,22648175,22167933,44816108,0
"1627",32,"Colombia","2011",45308899,22903701,22405198,45308899,0
"1628",32,"Colombia","2012",45782417,23149997,22632420,45782417,0
"1629",32,"Colombia","2013",46237930,23387544,22850386,46237930,0
"1630",32,"Colombia","2014",46677947,23617367,23060580,46677947,0
"1631",32,"Colombia","2015",47119728,23847355,23272374,47119729,-1
"1632",32,"Colombia","2016",47625955,24107989,23517966,47625955,0
"1633",32,"Colombia","2017",48351671,24477100,23874571,48351671,0
"1634",32,"Colombia","2018",49276961,24945907,24331054,49276961,0
"1635",32,"Colombia","2019",50187406,25408106,24779301,50187407,-1
"1636",32,"Colombia","2020",50930662,25791075,25139588,50930663,-1
"1637",32,"Colombia","2021",51516562,26101321,25415242,51516563,-1
"1638",32,"Colombia","2022",51874024,26298417,25575607,51874024,0
"1639",4,"Africa_Southern","1960",34920798,17780564,17140233,34920797,1
"1640",4,"Africa_Southern","1961",35790034,18209058,17580978,35790036,-2
"1641",4,"Africa_Southern","1962",36694745,18657614,18037130,36694744,1
"1642",4,"Africa_Southern","1963",37627799,19120193,18507607,37627800,-1
"1643",4,"Africa_Southern","1964",38586925,19595254,18991670,38586924,1
"1644",4,"Africa_Southern","1965",39563008,20079191,19483816,39563007,1
"1645",4,"Africa_Southern","1966",40551967,20569365,19982603,40551968,-1
"1646",4,"Africa_Southern","1967",41565351,21068894,20496459,41565353,-2
"1647",4,"Africa_Southern","1968",42631094,21592111,21038983,42631094,0
"1648",4,"Africa_Southern","1969",43769022,22153941,21615082,43769023,-1
"1649",4,"Africa_Southern","1970",44982355,22768014,22214341,44982355,0
"1650",4,"Africa_Southern","1971",46293905,23442914,22850988,46293902,3
"1651",4,"Africa_Southern","1972",47735381,24183678,23551700,47735378,3
"1652",4,"Africa_Southern","1973",49286105,24980595,24305510,49286105,0
"1653",4,"Africa_Southern","1974",50916451,25817470,25098981,50916451,0
"1654",4,"Africa_Southern","1975",52619785,26693504,25926279,52619783,2
"1655",4,"Africa_Southern","1976",54381393,27604250,26777144,54381394,-1
"1656",4,"Africa_Southern","1977",56197985,28559009,27638975,56197984,1
"1657",4,"Africa_Southern","1978",58025103,29550742,28474360,58025102,1
"1658",4,"Africa_Southern","1979",59906975,30569515,29337458,59906973,2
"1659",4,"Africa_Southern","1980",61999834,31592602,30407232,61999834,0
"1660",4,"Africa_Southern","1981",64120152,32615812,31504339,64120151,1
"1661",4,"Africa_Southern","1982",66179288,33673979,32505311,66179290,-2
"1662",4,"Africa_Southern","1983",68346133,34780323,33565809,68346132,1
"1663",4,"Africa_Southern","1984",70538477,35914173,34624303,70538476,1
"1664",4,"Africa_Southern","1985",72773465,37065675,35707791,72773466,-1
"1665",4,"Africa_Southern","1986",75047666,38227598,36820069,75047667,-1
"1666",4,"Africa_Southern","1987",77270330,39375659,37894674,77270333,-3
"1667",4,"Africa_Southern","1988",79476413,40541543,38934872,79476415,-2
"1668",4,"Africa_Southern","1989",81745300,41742762,40002540,81745302,-2
"1669",4,"Africa_Southern","1990",84041561,42937342,41104216,84041558,3
"1670",4,"Africa_Southern","1991",86286059,44103048,42183008,86286056,3
"1671",4,"Africa_Southern","1992",88527423,45278314,43249109,88527423,0
"1672",4,"Africa_Southern","1993",90847634,46481653,44365982,90847635,-1
"1673",4,"Africa_Southern","1994",93364208,47751068,45613145,93364213,-5
"1674",4,"Africa_Southern","1995",95894802,49033864,46860937,95894801,1
"1675",4,"Africa_Southern","1996",98155274,50210940,47944336,98155276,-2
"1676",4,"Africa_Southern","1997",100462860,51408169,49054689,100462858,2
"1677",4,"Africa_Southern","1998",102952256,52682503,50269752,102952255,1
"1678",4,"Africa_Southern","1999",105502514,53996926,51505593,105502519,-5
"1679",4,"Africa_Southern","2000",108156722,55363600,52793122,108156722,0
"1680",4,"Africa_Southern","2001",110837733,56741171,54096564,110837735,-2
"1681",4,"Africa_Southern","2002",113574050,58148061,55425989,113574050,0
"1682",4,"Africa_Southern","2003",116440895,59621531,56819365,116440896,-1
"1683",4,"Africa_Southern","2004",119436317,61162054,58274264,119436318,-1
"1684",4,"Africa_Southern","2005",122551831,62763811,59788020,122551831,0
"1685",4,"Africa_Southern","2006",125850515,64451101,61399413,125850514,1
"1686",4,"Africa_Southern","2007",129300740,66209691,63091050,129300741,-1
"1687",4,"Africa_Southern","2008",132831469,68011733,64819733,132831466,3
"1688",4,"Africa_Southern","2009",136420067,69855409,66564658,136420067,0
"1689",4,"Africa_Southern","2010",140212316,71797801,68414519,140212320,-4
"1690",4,"Africa_Southern","2011",144282681,73865284,70417400,144282684,-3
"1691",4,"Africa_Southern","2012",148562337,76029889,72532449,148562338,-1
"1692",4,"Africa_Southern","2013",153081595,78303324,74778270,153081594,1
"1693",4,"Africa_Southern","2014",157777589,80662213,77115375,157777588,1
"1694",4,"Africa_Southern","2015",162696231,83117155,79579075,162696230,1
"1695",4,"Africa_Southern","2016",167841294,85669833,82171458,167841291,3
"1696",4,"Africa_Southern","2017",173063804,88269042,84794765,173063807,-3
"1697",4,"Africa_Southern","2018",178259348,90875593,87383756,178259349,-1
"1698",4,"Africa_Southern","2019",183455845,93498517,89957326,183455843,2
"1699",4,"Africa_Southern","2020",188755940,96170631,92585310,188755941,-1
"1700",4,"Africa_Southern","2021",194117870,98871580,95246292,194117872,-2
"1701",4,"Africa_Southern","2022",199504585,101587534,97917052,199504586,-1
"1702",5,"Africa_Western","1960",112600886,56808208,55792674,112600882,4
"1703",5,"Africa_Western","1961",115056017,58050778,57005244,115056022,-5
"1704",5,"Africa_Western","1962",117600636,59333929,58266704,117600633,3
"1705",5,"Africa_Western","1963",120255784,60664322,59591461,120255783,1
"1706",5,"Africa_Western","1964",122996826,62039551,60957275,122996826,0
"1707",5,"Africa_Western","1965",125846187,63468775,62377412,125846187,0
"1708",5,"Africa_Western","1966",128812791,64951301,63861497,128812798,-7
"1709",5,"Africa_Western","1967",131865619,66481386,65384237,131865623,-4
"1710",5,"Africa_Western","1968",135019261,68067580,66951682,135019262,-1
"1711",5,"Africa_Western","1969",138274923,69700684,68574233,138274917,6
"1712",5,"Africa_Western","1970",141654113,71385068,70269047,141654115,-2
"1713",5,"Africa_Western","1971",145128217,73103475,72024744,145128219,-2
"1714",5,"Africa_Western","1972",148718288,74875981,73842308,148718289,-1
"1715",5,"Africa_Western","1973",152499485,76744745,75754739,152499484,1
"1716",5,"Africa_Western","1974",156486496,78716711,77769785,156486496,0
"1717",5,"Africa_Western","1975",160687365,80797909,79889456,160687365,0
"1718",5,"Africa_Western","1976",165001494,82938533,82062962,165001495,-1
"1719",5,"Africa_Western","1977",169469614,85166833,84302781,169469614,0
"1720",5,"Africa_Western","1978",174314566,87595122,86719446,174314568,-2
"1721",5,"Africa_Western","1979",179457442,90173921,89283526,179457447,-5
"1722",5,"Africa_Western","1980",184631505,92766708,91864794,184631502,3
"1723",5,"Africa_Western","1981",189880266,95391552,94488714,189880266,0
"1724",5,"Africa_Western","1982",195343535,98122132,97221406,195343538,-3
"1725",5,"Africa_Western","1983",200674465,100791774,99882692,200674466,-1
"1726",5,"Africa_Western","1984",206038844,103465391,102573452,206038843,1
"1727",5,"Africa_Western","1985",211723970,106287928,105436040,211723968,2
"1728",5,"Africa_Western","1986",217554342,109186825,108367517,217554342,0
"1729",5,"Africa_Western","1987",223584136,112183732,111400404,223584136,0
"1730",5,"Africa_Western","1988",229834287,115281367,114552914,229834281,6
"1731",5,"Africa_Western","1989",236335536,118501631,117833904,236335535,1
"1732",5,"Africa_Western","1990",242846908,121734995,121111907,242846902,6
"1733",5,"Africa_Western","1991",249490784,125043446,124447342,249490788,-4
"1734",5,"Africa_Western","1992",256424051,128499229,127924823,256424052,-1
"1735",5,"Africa_Western","1993",263497792,132022475,131475317,263497792,0
"1736",5,"Africa_Western","1994",271318426,135918966,135399464,271318430,-4
"1737",5,"Africa_Western","1995",279280352,139892867,139387487,279280354,-2
"1738",5,"Africa_Western","1996",286454381,143482140,142972245,286454385,-4
"1739",5,"Africa_Western","1997",293672949,147100479,146572469,293672948,1
"1740",5,"Africa_Western","1998",301518232,151029732,150488499,301518231,1
"1741",5,"Africa_Western","1999",309766076,155155440,154610641,309766081,-5
"1742",5,"Africa_Western","2000",318371929,159449821,158922108,318371929,0
"1743",5,"Africa_Western","2001",327413012,163953805,163459209,327413014,-2
"1744",5,"Africa_Western","2002",336764234,168600952,168163280,336764232,2
"1745",5,"Africa_Western","2003",346337350,173343033,172994315,346337348,2
"1746",5,"Africa_Western","2004",356238551,178246153,177992397,356238550,1
"1747",5,"Africa_Western","2005",366536756,183350771,183185986,366536757,-1
"1748",5,"Africa_Western","2006",377148839,188609150,188539690,377148840,-1
"1749",5,"Africa_Western","2007",388072105,194012807,194059297,388072104,1
"1750",5,"Africa_Western","2008",399317563,199574286,199743279,399317565,-2
"1751",5,"Africa_Western","2009",410923581,205313572,205610006,410923578,3
"1752",5,"Africa_Western","2010",422911157,211242576,211668581,422911157,0
"1753",5,"Africa_Western","2011",435329517,217392411,217937110,435329521,-4
"1754",5,"Africa_Western","2012",447985793,223666783,224319007,447985790,3
"1755",5,"Africa_Western","2013",460858331,230048323,230810008,460858331,0
"1756",5,"Africa_Western","2014",474088592,236606165,237482431,474088596,-4
"1757",5,"Africa_Western","2015",487548403,243274192,244274209,487548401,2
"1758",5,"Africa_Western","2016",501413993,250135450,251278548,501413998,-5
"1759",5,"Africa_Western","2017",515630013,257166906,258463109,515630015,-2
"1760",5,"Africa_Western","2018",529945524,264249986,265695539,529945525,-1
"1761",5,"Africa_Western","2019",544427552,271418811,273008740,544427551,1
"1762",5,"Africa_Western","2020",559260907,278774305,280486602,559260907,0
"1763",5,"Africa_Western","2021",574303132,286244650,288058485,574303135,-3
"1764",5,"Africa_Western","2022",589568462,293827923,295740537,589568460,2
"1765",6,"Australia_NZ","1960",12648277,6264752,6383524,12648276,1
"1766",6,"Australia_NZ","1961",12902700,6391986,6510713,12902699,1
"1767",6,"Australia_NZ","1962",13224000,6556931,6667068,13223999,1
"1768",6,"Australia_NZ","1963",13481800,6690807,6790993,13481800,0
"1769",6,"Australia_NZ","1964",13752400,6828724,6923676,13752400,0
"1770",6,"Australia_NZ","1965",14016400,6962198,7054202,14016400,0
"1771",6,"Australia_NZ","1966",14326900,7119151,7207750,14326901,-1
"1772",6,"Australia_NZ","1967",14523100,7220586,7302514,14523100,0
"1773",6,"Australia_NZ","1968",14757100,7341083,7416018,14757101,-1
"1774",6,"Australia_NZ","1969",15035800,7482567,7553233,15035800,0
"1775",6,"Australia_NZ","1970",15317700,7625310,7692390,15317700,0
"1776",6,"Australia_NZ","1971",15790000,7863829,7926170,15789999,1
"1777",6,"Australia_NZ","1972",16080900,8011913,8068989,16080902,-2
"1778",6,"Australia_NZ","1973",16341300,8144318,8196983,16341301,-1
"1779",6,"Australia_NZ","1974",16746700,8350064,8396636,16746700,0
"1780",6,"Australia_NZ","1975",16976100,8470289,8505811,16976100,0
"1781",6,"Australia_NZ","1976",17143500,8561083,8582418,17143501,-1
"1782",6,"Australia_NZ","1977",17312200,8653215,8658984,17312199,1
"1783",6,"Australia_NZ","1978",17479200,8744669,8734529,17479198,2
"1784",6,"Australia_NZ","1979",17623000,8823993,8799007,17623000,0
"1785",6,"Australia_NZ","1980",17804900,8921121,8883777,17804898,2
"1786",6,"Australia_NZ","1981",18048160,9046290,9001871,18048161,-1
"1787",6,"Australia_NZ","1982",18340347,9193113,9147233,18340346,1
"1788",6,"Australia_NZ","1983",18592772,9319508,9273264,18592772,0
"1789",6,"Australia_NZ","1984",18806491,9427691,9378800,18806491,0
"1790",6,"Australia_NZ","1985",19035412,9542691,9492720,19035411,1
"1791",6,"Australia_NZ","1986",19264650,9658298,9606352,19264650,0
"1792",6,"Australia_NZ","1987",19538274,9799698,9738575,19538273,1
"1793",6,"Australia_NZ","1988",19815564,9944729,9870835,19815564,0
"1794",6,"Australia_NZ","1989",20113616,10099342,10014273,20113615,1
"1795",6,"Australia_NZ","1990",20394928,10245262,10149667,20394929,-1
"1796",6,"Australia_NZ","1991",20779136,10444273,10334862,20779135,1
"1797",6,"Australia_NZ","1992",21010335,10564745,10445589,21010334,1
"1798",6,"Australia_NZ","1993",21207008,10666896,10540112,21207008,0
"1799",6,"Australia_NZ","1994",21425468,10779551,10645918,21425469,-1
"1800",6,"Australia_NZ","1995",21678282,10909214,10769068,21678282,0
"1801",6,"Australia_NZ","1996",21956767,11053795,10902973,21956768,-1
"1802",6,"Australia_NZ","1997",22204337,11185581,11018758,22204339,-2
"1803",6,"Australia_NZ","1998",22422584,11303222,11119361,22422583,1
"1804",6,"Australia_NZ","1999",22647364,11423291,11224073,22647364,0
"1805",6,"Australia_NZ","2000",22886502,11549658,11336844,22886502,0
"1806",6,"Australia_NZ","2001",23155201,11688042,11467157,23155199,2
"1807",6,"Australia_NZ","2002",23443710,11833157,11610552,23443709,1
"1808",6,"Australia_NZ","2003",23747937,11985644,11762293,23747937,0
"1809",6,"Australia_NZ","2004",24020222,12122211,11898011,24020222,0
"1810",6,"Australia_NZ","2005",24310744,12267714,12043030,24310744,0
"1811",6,"Australia_NZ","2006",24635566,12428994,12206573,24635567,-1
"1812",6,"Australia_NZ","2007",25051422,12632610,12418812,25051422,0
"1813",6,"Australia_NZ","2008",25508999,12854385,12654612,25508997,2
"1814",6,"Australia_NZ","2009",25994253,13092177,12902077,25994254,-1
"1815",6,"Australia_NZ","2010",26382450,13287126,13095324,26382450,0
"1816",6,"Australia_NZ","2011",26724024,13461346,13262678,26724024,0
"1817",6,"Australia_NZ","2012",27141565,13673344,13468222,27141566,-1
"1818",6,"Australia_NZ","2013",27570229,13892545,13677683,27570228,1
"1819",6,"Australia_NZ","2014",27992186,14111341,13880846,27992187,-1
"1820",6,"Australia_NZ","2015",28425395,14336996,14088398,28425394,1
"1821",6,"Australia_NZ","2016",28905007,14584712,14320295,28905007,0
"1822",6,"Australia_NZ","2017",29407802,14840473,14567328,29407801,1
"1823",6,"Australia_NZ","2018",29867243,15069180,14798064,29867244,-1
"1824",6,"Australia_NZ","2019",30319417,15287207,15032210,30319417,0
"1825",6,"Australia_NZ","2020",30745489,15492347,15253142,30745489,0
"1826",6,"Australia_NZ","2021",30799479,15514125,15285354,30799479,0
"1827",6,"Australia_NZ","2022",31103035,15663253,15439784,31103037,-2
"1828",7,"Brazil","1960",73092515,36434422,36658093,73092515,0
"1829",7,"Brazil","1961",75330008,37566819,37763189,75330008,0
"1830",7,"Brazil","1962",77599218,38718365,38880853,77599218,0
"1831",7,"Brazil","1963",79915555,39893199,40022356,79915555,0
"1832",7,"Brazil","1964",82262794,41083812,41178982,82262794,0
"1833",7,"Brazil","1965",84623747,42281945,42341802,84623747,0
"1834",7,"Brazil","1966",86979283,43477993,43501291,86979284,-1
"1835",7,"Brazil","1967",89323288,44668772,44654516,89323288,0
"1836",7,"Brazil","1968",91659246,45856024,45803221,91659245,1
"1837",7,"Brazil","1969",94000381,47045815,46954565,94000380,1
"1838",7,"Brazil","1970",96369875,48249510,48120365,96369875,0
"1839",7,"Brazil","1971",98766288,49466950,49299338,98766288,0
"1840",7,"Brazil","1972",101194394,50700362,50494031,101194393,1
"1841",7,"Brazil","1973",103666904,51955901,51711003,103666904,0
"1842",7,"Brazil","1974",106167372,53224988,52942384,106167372,0
"1843",7,"Brazil","1975",108700515,54509482,54191033,108700515,0
"1844",7,"Brazil","1976",111286504,55819649,55466856,111286505,-1
"1845",7,"Brazil","1977",113939886,57163358,56776528,113939886,0
"1846",7,"Brazil","1978",116664382,58542728,58121654,116664382,0
"1847",7,"Brazil","1979",119447303,59950908,59496395,119447303,0
"1848",7,"Brazil","1980",122288383,61387462,60900921,122288383,0
"1849",7,"Brazil","1981",125168060,62842666,62325393,125168059,1
"1850",7,"Brazil","1982",128065095,64306211,63758884,128065095,0
"1851",7,"Brazil","1983",130977370,65777066,65200304,130977370,0
"1852",7,"Brazil","1984",133888775,67247792,66640984,133888776,-1
"1853",7,"Brazil","1985",136783180,68711168,68072012,136783180,0
"1854",7,"Brazil","1986",139643355,70158889,69484466,139643355,0
"1855",7,"Brazil","1987",142466264,71589812,70876452,142466264,0
"1856",7,"Brazil","1988",145253973,73004388,72249586,145253974,-1
"1857",7,"Brazil","1989",148003411,74400370,73603042,148003412,-1
"1858",7,"Brazil","1990",150706446,75779994,74926452,150706446,0
"1859",7,"Brazil","1991",153336445,77129183,76207261,153336444,1
"1860",7,"Brazil","1992",155900790,78445848,77454942,155900790,0
"1861",7,"Brazil","1993",158440875,79750902,78689973,158440875,0
"1862",7,"Brazil","1994",160980472,81055777,79924696,160980473,-1
"1863",7,"Brazil","1995",163515328,82360145,81155182,163515327,1
"1864",7,"Brazil","1996",166037122,83659561,82377561,166037122,0
"1865",7,"Brazil","1997",168546707,84953439,83593268,168546707,0
"1866",7,"Brazil","1998",171039804,86240036,84799768,171039804,0
"1867",7,"Brazil","1999",173486281,87504861,85981420,173486281,0
"1868",7,"Brazil","2000",175873720,88749390,87124330,175873720,0
"1869",7,"Brazil","2001",178211881,89978663,88233218,178211881,0
"1870",7,"Brazil","2002",180476685,91173105,89303580,180476685,0
"1871",7,"Brazil","2003",182629278,92310671,90318606,182629277,1
"1872",7,"Brazil","2004",184722043,93418462,91303580,184722042,1
"1873",7,"Brazil","2005",186797334,94515633,92281701,186797334,0
"1874",7,"Brazil","2006",188820682,95583318,93237364,188820682,0
"1875",7,"Brazil","2007",190779453,96616434,94163019,190779453,0
"1876",7,"Brazil","2008",192672317,97612571,95059746,192672317,0
"1877",7,"Brazil","2009",194517549,98581682,95935867,194517549,0
"1878",7,"Brazil","2010",196353492,99546667,96806825,196353492,0
"1879",7,"Brazil","2011",198185302,100509285,97676016,198185301,1
"1880",7,"Brazil","2012",199977707,101450818,98526889,199977707,0
"1881",7,"Brazil","2013",201721767,102366379,99355387,201721766,1
"1882",7,"Brazil","2014",203459650,103274465,100185186,203459651,-1
"1883",7,"Brazil","2015",205188205,104179515,101008689,205188204,1
"1884",7,"Brazil","2016",206859578,105065188,101794390,206859578,0
"1885",7,"Brazil","2017",208504960,105937948,102567011,208504959,1
"1886",7,"Brazil","2018",210166592,106812144,103354449,210166593,-1
"1887",7,"Brazil","2019",211782878,107663080,104119798,211782878,0
"1888",7,"Brazil","2020",213196304,108417015,104779288,213196303,1
"1889",7,"Brazil","2021",214326223,109034931,105291292,214326223,0
"1890",7,"Brazil","2022",215313498,109580471,105733027,215313498,0
"1891",8,"Canada","1960",17909356,8850971,9058385,17909356,0
"1892",8,"Canada","1961",18271000,9040809,9230191,18271000,0
"1893",8,"Canada","1962",18614000,9223459,9390542,18614001,-1
"1894",8,"Canada","1963",18964000,9409673,9554327,18964000,0
"1895",8,"Canada","1964",19325000,9600426,9724573,19324999,1
"1896",8,"Canada","1965",19678000,9786254,9891746,19678000,0
"1897",8,"Canada","1966",20048000,9978791,10069210,20048001,-1
"1898",8,"Canada","1967",20412000,10166027,10245973,20412000,0
"1899",8,"Canada","1968",20744000,10337254,10406746,20744000,0
"1900",8,"Canada","1969",21028000,10486530,10541470,21028000,0
"1901",8,"Canada","1970",21324000,10633366,10690634,21324000,0
"1902",8,"Canada","1971",21962032,10944078,11017954,21962032,0
"1903",8,"Canada","1972",22218463,11074818,11143645,22218463,0
"1904",8,"Canada","1973",22491777,11220294,11271483,22491777,0
"1905",8,"Canada","1974",22807969,11386049,11421920,22807969,0
"1906",8,"Canada","1975",23143275,11562890,11580385,23143275,0
"1907",8,"Canada","1976",23449808,11727923,11721886,23449809,-1
"1908",8,"Canada","1977",23725843,11879181,11846663,23725844,-1
"1909",8,"Canada","1978",23963203,12011533,11951670,23963203,0
"1910",8,"Canada","1979",24201544,12142187,12059357,24201544,0
"1911",8,"Canada","1980",24515667,12308181,12207486,24515667,0
"1912",8,"Canada","1981",24819915,12468647,12351269,24819916,-1
"1913",8,"Canada","1982",25116942,12625723,12491219,25116942,0
"1914",8,"Canada","1983",25366451,12759260,12607190,25366450,1
"1915",8,"Canada","1984",25607053,12887917,12719137,25607054,-1
"1916",8,"Canada","1985",25842116,13012495,12829620,25842115,1
"1917",8,"Canada","1986",26100278,13145756,12954522,26100278,0
"1918",8,"Canada","1987",26446601,13321982,13124619,26446601,0
"1919",8,"Canada","1988",26791747,13500396,13291351,26791747,0
"1920",8,"Canada","1989",27276781,13751532,13525249,27276781,0
"1921",8,"Canada","1990",27691138,13963399,13727739,27691138,0
"1922",8,"Canada","1991",28037420,14138442,13898978,28037420,0
"1923",8,"Canada","1992",28371264,14312897,14058366,28371263,1
"1924",8,"Canada","1993",28684764,14478794,14205971,28684765,-1
"1925",8,"Canada","1994",29000663,14643061,14357602,29000663,0
"1926",8,"Canada","1995",29302311,14799796,14502515,29302311,0
"1927",8,"Canada","1996",29610218,14956383,14653835,29610218,0
"1928",8,"Canada","1997",29905948,15103624,14802324,29905948,0
"1929",8,"Canada","1998",30155173,15229531,14925642,30155173,0
"1930",8,"Canada","1999",30401286,15353410,15047875,30401285,1
"1931",8,"Canada","2000",30685730,15492171,15193559,30685730,0
"1932",8,"Canada","2001",31020902,15654835,15366067,31020902,0
"1933",8,"Canada","2002",31360079,15821972,15538106,31360078,1
"1934",8,"Canada","2003",31644028,15963984,15680044,31644028,0
"1935",8,"Canada","2004",31940655,16112389,15828266,31940655,0
"1936",8,"Canada","2005",32243753,16263117,15980635,32243752,1
"1937",8,"Canada","2006",32571174,16427039,16144134,32571173,1
"1938",8,"Canada","2007",32889025,16588348,16300676,32889024,1
"1939",8,"Canada","2008",33247118,16769997,16477121,33247118,0
"1940",8,"Canada","2009",33628895,16962677,16666218,33628895,0
"1941",8,"Canada","2010",34004889,17152260,16852629,34004889,0
"1942",8,"Canada","2011",34339328,17318413,17020916,34339329,-1
"1943",8,"Canada","2012",34714222,17500980,17213242,34714222,0
"1944",8,"Canada","2013",35082954,17680037,17402916,35082953,1
"1945",8,"Canada","2014",35437435,17855282,17582153,35437435,0
"1946",8,"Canada","2015",35702908,17988513,17714395,35702908,0
"1947",8,"Canada","2016",36109487,18192222,17917265,36109487,0
"1948",8,"Canada","2017",36545236,18406915,18138320,36545235,1
"1949",8,"Canada","2018",37065084,18659541,18405543,37065084,0
"1950",8,"Canada","2019",37601230,18921018,18680213,37601231,-1
"1951",8,"Canada","2020",38007166,19121762,18885404,38007166,0
"1952",8,"Canada","2021",38226498,19230969,18995529,38226498,0
"1953",8,"Canada","2022",38929902,19583244,19346659,38929903,-1
"1954",9,"Central America and Caribbean","1960",31317416,15626444,15690973,31317417,-1
"1955",9,"Central America and Caribbean","1961",32113127,16024499,16088627,32113126,1
"1956",9,"Central America and Caribbean","1962",32922780,16428612,16494168,32922780,0
"1957",9,"Central America and Caribbean","1963",33746045,16838008,16908039,33746047,-2
"1958",9,"Central America and Caribbean","1964",34588213,17256914,17331300,34588214,-1
"1959",9,"Central America and Caribbean","1965",35444538,17684608,17759932,35444540,-2
"1960",9,"Central America and Caribbean","1966",36308943,18116725,18192216,36308941,2
"1961",9,"Central America and Caribbean","1967",37182074,18552635,18629436,37182071,3
"1962",9,"Central America and Caribbean","1968",38060738,18991683,19069053,38060736,2
"1963",9,"Central America and Caribbean","1969",38944680,19433757,19510919,38944676,4
"1964",9,"Central America and Caribbean","1970",39837524,19881157,19956365,39837522,2
"1965",9,"Central America and Caribbean","1971",40736954,20331866,20405090,40736956,-2
"1966",9,"Central America and Caribbean","1972",41629543,20778161,20851378,41629539,4
"1967",9,"Central America and Caribbean","1973",42517658,21221712,21295947,42517659,-1
"1968",9,"Central America and Caribbean","1974",43406970,21665822,21741148,43406970,0
"1969",9,"Central America and Caribbean","1975",44294320,22109412,22184908,44294320,0
"1970",9,"Central America and Caribbean","1976",45181989,22553521,22628468,45181989,0
"1971",9,"Central America and Caribbean","1977",46068906,22998371,23070533,46068904,2
"1972",9,"Central America and Caribbean","1978",46956125,23446019,23510105,46956124,1
"1973",9,"Central America and Caribbean","1979",47843847,23897395,23946444,47843839,8
"1974",9,"Central America and Caribbean","1980",48736361,24352774,24383590,48736364,-3
"1975",9,"Central America and Caribbean","1981",49625417,24810019,24815401,49625420,-3
"1976",9,"Central America and Caribbean","1982",50569401,25299987,25269411,50569398,3
"1977",9,"Central America and Caribbean","1983",51585354,25824066,25761283,51585349,5
"1978",9,"Central America and Caribbean","1984",52620082,26353133,26266949,52620082,0
"1979",9,"Central America and Caribbean","1985",53669945,26887826,26782117,53669943,2
"1980",9,"Central America and Caribbean","1986",54733310,27428193,27305118,54733311,-1
"1981",9,"Central America and Caribbean","1987",55812343,27975905,27836436,55812341,2
"1982",9,"Central America and Caribbean","1988",56917728,28535584,28382144,56917728,0
"1983",9,"Central America and Caribbean","1989",58043248,29105540,28937702,58043242,6
"1984",9,"Central America and Caribbean","1990",59182013,29681742,29500272,59182014,-1
"1985",9,"Central America and Caribbean","1991",60320551,30256907,30063646,60320553,-2
"1986",9,"Central America and Caribbean","1992",61450685,30828248,30622437,61450685,0
"1987",9,"Central America and Caribbean","1993",62563773,31391657,31172115,62563772,1
"1988",9,"Central America and Caribbean","1994",63652251,31938982,31713267,63652249,2
"1989",9,"Central America and Caribbean","1995",64730512,32476841,32253672,64730513,-1
"1990",9,"Central America and Caribbean","1996",65795907,33009129,32786778,65795907,0
"1991",9,"Central America and Caribbean","1997",66849625,33536126,33313498,66849624,1
"1992",9,"Central America and Caribbean","1998",67890528,34056207,33834324,67890531,-3
"1993",9,"Central America and Caribbean","1999",68929934,34576009,34353921,68929930,4
"1994",9,"Central America and Caribbean","2000",69984465,35104556,34879910,69984466,-1
"1995",9,"Central America and Caribbean","2001",71027322,35627634,35399682,71027316,6
"1996",9,"Central America and Caribbean","2002",72050225,36146110,35904115,72050225,0
"1997",9,"Central America and Caribbean","2003",73052848,36658491,36394354,73052845,3
"1998",9,"Central America and Caribbean","2004",74039548,37162154,36877398,74039552,-4
"1999",9,"Central America and Caribbean","2005",75019504,37662894,37356611,75019505,-1
"2000",9,"Central America and Caribbean","2006",75993946,38161406,37832544,75993950,-4
"2001",9,"Central America and Caribbean","2007",76973231,38661214,38312013,76973227,4
"2002",9,"Central America and Caribbean","2008",77965028,39166079,38798943,77965022,6
"2003",9,"Central America and Caribbean","2009",78960951,39673482,39287467,78960949,2
"2004",9,"Central America and Caribbean","2010",79913967,40157218,39756752,79913970,-3
"2005",9,"Central America and Caribbean","2011",80869436,40642349,40227095,80869444,-8
"2006",9,"Central America and Caribbean","2012",81869148,41152106,40717045,81869151,-3
"2007",9,"Central America and Caribbean","2013",82867018,41661095,41205920,82867015,3
"2008",9,"Central America and Caribbean","2014",83856773,42166609,41690164,83856773,0
"2009",9,"Central America and Caribbean","2015",84835893,42667724,42168168,84835892,1
"2010",9,"Central America and Caribbean","2016",85799306,43162322,42636982,85799304,2
"2011",9,"Central America and Caribbean","2017",86744434,43648868,43095564,86744432,2
"2012",9,"Central America and Caribbean","2018",87690081,44131378,43558698,87690076,5
"2013",9,"Central America and Caribbean","2019",88602053,44599526,44002521,88602047,6
"2014",9,"Central America and Caribbean","2020",89486623,45061924,44424696,89486620,3
"2015",9,"Central America and Caribbean","2021",90334967,45509000,44825968,90334968,-1
"2016",9,"Central America and Caribbean","2022",91158339,45941461,45216874,91158335,4
